date,project,pod,regression_tests_automated,regression_tests_refactored,regression_tests_executed,regression_tests_passed,regression_tests_failed,shakedown_tests_automated,shakedown_tests_refactored,shakedown_tests_executed,shakedown_tests_passed,shakedown_tests_failed,defects_reported
01-01-2021,Discovery,2,910,711,532,400,132,90,29,6,1,5,0
01-01-2021,PrimeSeven,1,614,474,477,397,80,84,58,58,2,56,1
01-01-2021,Mustangs,1,705,373,110,5,105,59,4,56,42,14,0
01-01-2021,Mustangs,1,536,243,419,137,282,98,76,41,0,41,0
01-01-2021,Aurora,2,773,130,663,45,618,93,41,19,6,13,0
01-01-2021,GrayPanthers,3,114,65,30,7,23,91,30,68,67,1,0
01-01-2021,Honeycomb,1,270,15,212,137,75,97,69,69,54,15,4
01-01-2021,PrimeSeven,2,608,49,561,119,442,73,27,35,19,16,2
01-01-2021,Honeycomb,1,991,791,537,423,114,100,65,34,2,32,0
01-01-2022,Honeycomb,1,906,215,13,6,7,83,26,48,7,41,2
01-01-2022,CelestialInterface,3,965,705,652,146,506,95,79,17,4,13,0
01-01-2022,PrimeSeven,2,606,322,594,222,372,100,56,58,44,14,3
01-01-2022,Quicksilver,1,922,311,738,636,102,62,20,19,13,6,0
01-01-2022,PrimeSeven,1,517,181,30,19,11,67,52,25,5,20,1
01-01-2022,Discovery,1,186,96,96,95,1,81,49,77,52,25,0
01-01-2022,Mustangs,1,600,79,229,25,204,50,43,49,19,30,0
01-01-2022,Aurora,1,328,119,212,199,13,78,23,54,2,52,4
01-01-2022,Discovery,2,207,196,54,33,21,54,12,7,1,6,0
01-01-2023,ImpactTraining,2,308,101,72,20,52,74,10,41,35,6,2
01-01-2023,Quicksilver,3,573,464,94,49,45,62,45,53,15,38,1
01-01-2023,Honeycomb,1,475,331,280,174,106,85,1,31,7,24,1
01-01-2023,Honeycomb,2,584,583,132,125,7,50,27,39,32,7,2
01-01-2023,BitterLaser,2,814,301,527,29,498,80,12,2,1,1,0
01-01-2023,ImpactTraining,2,905,417,668,593,75,100,36,25,14,11,2
01-01-2023,Aurora,1,655,145,212,168,44,97,90,44,39,5,2
01-01-2023,Discovery,2,769,55,436,47,389,60,24,0,0,0,0
01-01-2023,Aurora,2,169,145,112,79,33,63,37,44,2,42,5
01-01-2023,Discovery,2,383,157,282,82,200,78,28,15,13,2,0
01-01-2023,CelestialInterface,1,804,11,306,13,293,94,43,55,29,26,3
01-01-2023,Aurora,2,192,70,117,97,20,53,26,18,7,11,0
01-01-2023,PrimeSeven,2,272,200,242,61,181,89,80,24,19,5,2
01-02-2021,Mustangs,2,181,173,158,33,125,50,39,38,14,24,4
01-02-2021,Quicksilver,3,651,394,600,541,59,75,15,64,59,5,8
01-02-2021,Honeycomb,1,859,661,368,257,111,96,92,73,4,69,3
01-02-2021,Discovery,2,220,29,159,64,95,100,2,17,14,3,1
01-02-2021,GrayPanthers,2,641,119,54,34,20,59,23,56,39,17,5
01-02-2021,Quicksilver,2,592,503,444,22,422,73,10,20,12,8,1
01-02-2021,BitterLaser,2,238,163,160,103,57,59,34,13,9,4,0
01-02-2021,GrayPanthers,3,319,68,79,63,16,90,51,37,35,2,0
01-02-2021,PrimeSeven,2,897,658,367,62,305,55,27,11,5,6,0
01-02-2022,Discovery,2,679,100,347,302,45,72,54,26,24,2,0
01-02-2022,BitterLaser,1,106,39,81,17,64,97,73,28,4,24,0
01-02-2022,CelestialInterface,1,984,238,382,373,9,60,20,9,4,5,0
01-02-2022,PrimeSeven,2,352,323,109,91,18,80,38,48,8,40,6
01-02-2022,ImpactTraining,2,226,206,7,6,1,68,49,27,3,24,2
01-02-2022,Mustangs,2,335,274,67,64,3,50,21,25,14,11,0
01-02-2022,Discovery,3,772,668,602,446,156,95,46,4,3,1,0
01-02-2023,BitterLaser,2,453,257,336,12,324,84,48,47,36,11,0
01-02-2023,Mustangs,2,634,311,376,70,306,67,52,45,5,40,2
01-02-2023,BitterLaser,2,970,151,440,346,94,60,52,6,1,5,0
01-02-2023,CelestialInterface,1,381,221,379,298,81,77,21,44,14,30,4
01-02-2023,Mustangs,3,449,433,350,349,1,85,83,3,2,1,0
01-02-2023,GrayPanthers,3,959,61,709,419,290,62,38,58,5,53,6
01-02-2023,Discovery,3,647,164,120,20,100,53,19,17,0,17,0
01-02-2023,Discovery,3,710,567,81,31,50,65,37,25,8,17,2
01-02-2023,BitterLaser,3,446,400,356,254,102,67,32,26,7,19,1
01-02-2023,Honeycomb,3,492,29,84,14,70,50,24,29,16,13,3
01-03-2021,Aurora,3,741,616,254,1,253,57,6,24,23,1,0
01-03-2021,GrayPanthers,3,310,135,108,106,2,67,15,62,5,57,8
01-03-2021,BitterLaser,3,600,311,330,299,31,91,53,85,23,62,9
01-03-2021,BitterLaser,1,805,258,49,43,6,51,0,39,0,39,3
01-03-2021,BitterLaser,2,134,27,129,122,7,66,28,62,13,49,2
01-03-2021,Mustangs,3,428,417,225,195,30,98,13,55,52,3,0
01-03-2021,Honeycomb,1,456,147,119,41,78,81,54,9,2,7,0
01-03-2021,BitterLaser,2,114,86,69,36,33,78,63,60,54,6,6
01-03-2021,Honeycomb,1,476,463,88,83,5,55,16,14,11,3,1
01-03-2021,Quicksilver,2,424,355,246,109,137,93,63,13,7,6,0
01-03-2022,Quicksilver,1,864,23,355,188,167,80,72,11,8,3,0
01-03-2022,BitterLaser,2,989,412,954,707,247,62,29,60,56,4,5
01-03-2022,Quicksilver,2,372,351,362,328,34,87,48,67,38,29,2
01-03-2022,Discovery,3,300,121,244,179,65,71,42,56,30,26,3
01-03-2022,Honeycomb,2,290,121,165,7,158,57,44,26,24,2,1
01-03-2022,BitterLaser,1,189,21,23,16,7,50,14,15,12,3,0
01-03-2022,Aurora,3,382,372,318,160,158,53,23,37,27,10,3
01-03-2023,Quicksilver,1,288,109,146,86,60,76,37,4,3,1,0
01-03-2023,Quicksilver,1,791,224,274,34,240,73,54,46,24,22,2
01-03-2023,Aurora,1,914,109,560,358,202,74,56,29,1,28,2
01-03-2023,CelestialInterface,3,252,137,130,82,48,76,13,2,0,2,0
01-03-2023,Aurora,2,367,44,73,44,29,65,17,42,20,22,1
01-03-2023,Quicksilver,1,430,382,178,91,87,83,58,41,30,11,3
01-03-2023,PrimeSeven,3,316,214,198,6,192,77,54,61,16,45,1
01-03-2023,Mustangs,1,797,399,658,461,197,68,14,62,1,61,1
01-03-2023,PrimeSeven,2,809,76,552,384,168,70,36,65,42,23,0
01-03-2023,ImpactTraining,2,942,758,105,51,54,69,0,13,12,1,0
01-04-2021,BitterLaser,1,306,241,253,86,167,76,3,59,58,1,4
01-04-2021,CelestialInterface,2,823,680,600,377,223,75,20,3,2,1,0
01-04-2021,Quicksilver,1,416,83,309,112,197,52,17,50,19,31,3
01-04-2021,Honeycomb,3,337,268,108,5,103,97,71,6,1,5,0
01-04-2021,ImpactTraining,2,884,240,498,450,48,97,47,89,41,48,3
01-04-2021,PrimeSeven,3,415,404,295,288,7,54,5,32,10,22,1
01-04-2021,Quicksilver,1,489,53,336,295,41,58,15,37,31,6,1
01-04-2021,Aurora,2,921,758,811,269,542,60,47,52,48,4,2
01-04-2022,CelestialInterface,3,345,79,139,69,70,79,0,65,51,14,7
01-04-2022,Honeycomb,2,459,90,380,277,103,50,22,10,2,8,0
01-04-2022,BitterLaser,2,268,37,65,34,31,95,58,10,5,5,0
01-04-2022,Mustangs,2,288,206,160,121,39,80,51,19,8,11,1
01-04-2022,Honeycomb,1,949,508,851,482,369,75,12,20,7,13,1
01-04-2022,Mustangs,3,696,123,77,58,19,75,31,45,11,34,2
01-04-2022,BitterLaser,3,308,155,248,89,159,93,54,91,11,80,0
01-04-2022,Quicksilver,1,383,244,161,83,78,81,75,12,0,12,0
01-04-2022,ImpactTraining,3,203,16,176,49,127,51,35,50,12,38,4
01-04-2022,Honeycomb,3,999,712,369,70,299,63,55,39,5,34,2
01-04-2022,Aurora,2,152,100,53,47,6,54,6,21,6,15,0
01-04-2022,GrayPanthers,2,790,403,471,221,250,69,13,1,0,1,0
01-04-2022,BitterLaser,3,622,180,130,124,6,52,12,35,17,18,1
01-04-2022,ImpactTraining,1,245,74,131,52,79,52,45,7,1,6,0
01-04-2023,CelestialInterface,2,434,310,249,238,11,53,24,31,17,14,3
01-04-2023,BitterLaser,3,500,407,309,5,304,99,92,58,20,38,3
01-04-2023,ImpactTraining,1,868,618,512,476,36,58,48,32,3,29,0
01-04-2023,Mustangs,1,477,332,450,143,307,50,37,16,15,1,1
01-04-2023,BitterLaser,3,608,537,368,103,265,65,0,42,23,19,3
01-04-2023,CelestialInterface,1,272,256,90,53,37,90,25,42,35,7,5
01-04-2023,Discovery,1,961,472,846,490,356,87,29,36,31,5,1
01-04-2023,BitterLaser,3,605,251,467,77,390,55,24,49,45,4,4
01-04-2023,PrimeSeven,2,874,535,689,29,660,88,66,30,17,13,1
01-04-2023,GrayPanthers,1,885,221,543,350,193,92,8,4,1,3,0
01-04-2023,Aurora,3,790,784,770,206,564,51,22,13,2,11,0
01-04-2023,CelestialInterface,1,522,475,470,468,2,79,46,12,10,2,0
01-04-2023,BitterLaser,1,130,74,119,52,67,77,39,14,8,6,0
01-04-2023,PrimeSeven,1,308,83,273,226,47,67,19,0,0,0,0
01-04-2023,ImpactTraining,1,649,321,622,18,604,55,47,52,18,34,4
01-05-2021,CelestialInterface,2,555,238,359,217,142,98,90,86,59,27,7
01-05-2021,Aurora,1,807,416,277,84,193,89,5,6,5,1,0
01-05-2021,Mustangs,2,806,40,82,72,10,53,13,31,26,5,0
01-05-2021,Discovery,2,921,427,190,119,71,69,38,3,1,2,0
01-05-2021,Discovery,2,658,559,582,233,349,79,65,17,8,9,0
01-05-2021,Discovery,3,938,909,403,308,95,82,27,7,1,6,0
01-05-2021,GrayPanthers,2,328,47,307,30,277,95,72,93,10,83,3
01-05-2021,ImpactTraining,3,128,98,86,40,46,58,48,2,1,1,0
01-05-2021,Aurora,1,579,148,270,205,65,54,35,17,5,12,1
01-05-2021,PrimeSeven,1,952,392,602,526,76,69,5,7,5,2,0
01-05-2022,Aurora,1,369,307,148,59,89,90,65,57,52,5,7
01-05-2022,BitterLaser,3,542,13,169,74,95,69,0,48,7,41,5
01-05-2022,Mustangs,2,802,600,319,222,97,89,46,29,4,25,1
01-05-2022,Aurora,3,521,67,268,177,91,83,38,63,62,1,4
01-05-2022,Mustangs,2,799,538,436,107,329,56,44,38,21,17,4
01-05-2022,BitterLaser,2,692,435,490,208,282,50,36,5,2,3,0
01-05-2023,CelestialInterface,1,286,17,226,173,53,96,73,7,0,7,0
01-05-2023,ImpactTraining,1,976,182,822,653,169,61,1,36,9,27,4
01-05-2023,Discovery,3,364,128,297,35,262,72,38,34,23,11,4
01-05-2023,Quicksilver,1,563,252,388,290,98,97,94,58,45,13,1
01-05-2023,Honeycomb,1,613,109,300,232,68,62,43,26,10,16,0
01-05-2023,Mustangs,1,274,268,259,173,86,76,8,50,27,23,4
01-05-2023,Discovery,3,151,2,122,6,116,80,20,33,3,30,2
01-05-2023,CelestialInterface,2,635,426,624,197,427,91,56,25,4,21,2
01-05-2023,CelestialInterface,1,533,76,180,89,91,60,19,15,5,10,0
01-06-2021,Honeycomb,1,382,353,260,229,31,84,44,61,26,35,4
01-06-2021,CelestialInterface,2,284,86,203,168,35,98,34,38,15,23,1
01-06-2021,Mustangs,1,876,482,288,145,143,84,66,18,14,4,1
01-06-2021,Mustangs,1,203,35,190,71,119,65,6,25,21,4,2
01-06-2021,GrayPanthers,1,264,10,88,84,4,53,11,34,23,11,3
01-06-2021,Quicksilver,3,746,171,112,65,47,68,17,18,0,18,1
01-06-2021,Quicksilver,3,995,484,367,174,193,98,92,84,54,30,10
01-06-2021,Discovery,1,319,32,55,43,12,50,45,3,0,3,0
01-06-2021,Quicksilver,1,794,479,215,64,151,94,28,70,44,26,1
01-06-2021,Honeycomb,3,603,567,198,97,101,92,23,47,27,20,4
01-06-2022,Discovery,2,496,358,8,1,7,50,41,34,26,8,3
01-06-2022,Quicksilver,3,155,27,113,106,7,97,80,8,4,4,0
01-06-2022,Quicksilver,2,497,50,54,19,35,70,34,30,17,13,0
01-06-2022,ImpactTraining,3,478,20,126,119,7,63,29,12,8,4,0
01-06-2022,CelestialInterface,2,350,272,106,55,51,78,48,62,20,42,8
01-06-2022,PrimeSeven,2,523,262,221,99,122,78,39,41,2,39,0
01-06-2022,Mustangs,2,221,55,91,89,2,97,85,96,65,31,5
01-06-2022,Mustangs,2,433,398,45,41,4,85,21,84,0,84,4
01-06-2022,PrimeSeven,3,264,72,158,124,34,94,59,14,2,12,0
01-06-2023,GrayPanthers,1,880,865,365,21,344,100,91,61,24,37,1
01-06-2023,BitterLaser,1,977,498,509,435,74,77,9,59,41,18,1
01-06-2023,Discovery,3,263,133,227,225,2,67,60,26,8,18,1
01-06-2023,Mustangs,2,958,375,426,391,35,76,74,24,20,4,2
01-06-2023,PrimeSeven,2,198,30,188,58,130,77,41,69,6,63,3
01-06-2023,PrimeSeven,3,827,725,119,51,68,77,24,58,47,11,4
01-06-2023,ImpactTraining,3,533,478,330,83,247,50,28,18,3,15,1
01-06-2023,Discovery,3,766,154,633,104,529,52,37,4,3,1,0
01-06-2023,PrimeSeven,1,963,311,463,71,392,89,88,37,33,4,1
01-06-2023,PrimeSeven,1,328,105,8,5,3,97,90,25,12,13,2
01-06-2023,BitterLaser,2,644,15,426,266,160,55,48,19,10,9,1
01-06-2023,GrayPanthers,3,104,72,16,9,7,76,46,18,7,11,0
01-07-2021,Aurora,1,459,128,337,0,337,55,23,30,11,19,1
01-07-2021,Honeycomb,1,123,46,39,31,8,66,62,39,29,10,3
01-07-2021,Aurora,2,707,189,6,3,3,55,35,33,17,16,2
01-07-2021,Aurora,3,561,16,539,83,456,87,50,84,78,6,5
01-07-2021,Mustangs,2,870,678,467,42,425,70,30,21,16,5,2
01-07-2021,PrimeSeven,2,806,755,364,184,180,77,39,37,8,29,0
01-07-2021,GrayPanthers,1,873,300,58,57,1,63,60,45,12,33,5
01-07-2021,Aurora,1,332,113,205,188,17,57,21,15,4,11,1
01-07-2021,ImpactTraining,3,391,263,336,211,125,72,48,35,26,9,2
01-07-2021,Honeycomb,1,889,243,182,153,29,56,45,12,11,1,0
01-07-2021,GrayPanthers,2,123,99,72,21,51,75,26,50,33,17,3
01-07-2022,Honeycomb,3,814,25,91,6,85,74,11,3,1,2,0
01-07-2022,Quicksilver,1,306,176,265,34,231,84,32,25,23,2,1
01-07-2022,Honeycomb,2,102,71,89,11,78,73,18,38,7,31,3
01-07-2022,Discovery,2,131,28,16,8,8,95,23,49,0,49,3
01-07-2022,CelestialInterface,3,233,179,34,31,3,80,65,49,32,17,1
01-07-2022,Aurora,2,288,27,57,4,53,82,70,57,41,16,4
01-07-2022,PrimeSeven,3,524,122,363,49,314,65,45,32,8,24,2
01-07-2022,PrimeSeven,3,173,116,107,1,106,56,31,29,14,15,1
01-07-2022,Discovery,3,211,18,98,1,97,67,30,33,29,4,1
01-07-2022,Aurora,3,543,301,141,40,101,93,38,33,29,4,0
01-07-2023,Discovery,1,232,47,156,90,66,92,55,38,31,7,2
01-07-2023,Discovery,1,851,671,754,258,496,89,71,56,25,31,2
01-07-2023,Quicksilver,3,634,227,625,234,391,76,34,4,2,2,0
01-07-2023,CelestialInterface,3,458,115,84,36,48,65,57,53,41,12,0
01-07-2023,GrayPanthers,1,134,125,128,76,52,92,54,40,16,24,2
01-07-2023,Mustangs,2,226,161,165,132,33,94,73,72,69,3,8
01-07-2023,Honeycomb,1,772,129,133,92,41,56,38,39,27,12,3
01-07-2023,ImpactTraining,2,494,101,359,77,282,80,8,67,38,29,6
01-07-2023,GrayPanthers,2,407,112,178,89,89,95,28,69,4,65,1
01-07-2023,Quicksilver,2,529,459,185,106,79,73,40,63,45,18,5
01-08-2021,GrayPanthers,2,463,74,297,35,262,79,63,29,26,3,1
01-08-2021,Aurora,2,344,225,337,197,140,91,37,52,48,4,0
01-08-2021,Mustangs,1,366,250,206,201,5,74,2,24,7,17,2
01-08-2021,ImpactTraining,3,510,134,221,114,107,64,52,0,0,0,0
01-08-2021,ImpactTraining,1,347,41,198,131,67,53,30,27,20,7,1
01-08-2021,Quicksilver,1,674,366,517,59,458,50,31,14,2,12,1
01-08-2022,Aurora,1,319,200,51,31,20,60,47,26,17,9,0
01-08-2022,CelestialInterface,3,312,287,306,78,228,99,18,87,20,67,7
01-08-2022,Aurora,2,888,549,664,657,7,64,12,33,17,16,2
01-08-2022,Discovery,3,922,566,295,27,268,61,24,47,21,26,4
01-08-2022,BitterLaser,3,276,82,118,88,30,67,47,17,15,2,0
01-08-2022,ImpactTraining,1,953,366,919,527,392,69,54,46,31,15,5
01-08-2022,BitterLaser,2,447,437,318,14,304,80,59,19,4,15,1
01-08-2022,Mustangs,2,710,505,144,139,5,97,29,27,22,5,0
01-08-2022,GrayPanthers,1,532,423,458,429,29,100,50,72,25,47,7
01-08-2022,PrimeSeven,1,125,44,119,6,113,62,2,43,31,12,1
01-08-2022,GrayPanthers,1,602,100,7,4,3,56,31,17,6,11,1
01-08-2023,Quicksilver,2,169,105,33,8,25,84,75,24,13,11,1
01-08-2023,Honeycomb,1,122,18,68,43,25,78,59,5,0,5,0
01-08-2023,BitterLaser,2,165,66,17,8,9,79,68,56,28,28,6
01-08-2023,BitterLaser,2,614,159,602,350,252,61,33,32,18,14,1
01-08-2023,PrimeSeven,2,282,199,2,1,1,64,17,5,3,2,0
01-08-2023,CelestialInterface,3,255,50,42,2,40,58,12,0,0,0,0
01-08-2023,Discovery,1,596,449,518,472,46,92,58,75,24,51,2
01-08-2023,Discovery,1,344,103,97,77,20,73,43,61,2,59,0
01-08-2023,Honeycomb,2,214,35,48,15,33,66,26,28,11,17,3
01-08-2023,Quicksilver,1,824,278,507,4,503,51,37,8,3,5,0
01-09-2021,ImpactTraining,1,197,32,130,43,87,66,10,47,42,5,5
01-09-2021,Mustangs,1,422,1,53,12,41,87,58,8,1,7,0
01-09-2021,Discovery,3,305,35,289,92,197,53,5,8,6,2,0
01-09-2021,Mustangs,2,347,57,282,228,54,65,18,62,35,27,7
01-09-2021,ImpactTraining,2,194,56,177,77,100,90,11,19,16,3,1
01-09-2021,BitterLaser,2,406,335,11,4,7,73,65,37,13,24,3
01-09-2021,PrimeSeven,3,299,273,55,19,36,53,14,45,8,37,0
01-09-2021,CelestialInterface,3,399,97,394,265,129,92,25,36,31,5,0
01-09-2021,Aurora,3,192,158,62,19,43,82,71,27,9,18,3
01-09-2021,Honeycomb,1,546,60,404,143,261,71,19,62,56,6,4
01-09-2021,Aurora,2,430,400,256,208,48,59,31,22,13,9,0
01-09-2021,Aurora,1,803,382,422,5,417,71,13,55,54,1,6
01-09-2022,BitterLaser,1,650,213,428,271,157,84,10,65,32,33,0
01-09-2022,ImpactTraining,3,809,1,360,259,101,95,75,38,19,19,1
01-09-2022,ImpactTraining,3,578,472,95,79,16,77,20,41,14,27,1
01-09-2022,Honeycomb,1,261,226,241,231,10,53,46,30,26,4,0
01-09-2022,Honeycomb,2,637,539,63,49,14,95,21,5,4,1,0
01-09-2022,Aurora,1,213,170,59,12,47,75,26,14,8,6,1
01-09-2022,Honeycomb,3,380,165,217,45,172,75,45,62,4,58,2
01-09-2022,Aurora,1,579,16,77,45,32,86,79,16,10,6,0
01-09-2022,Mustangs,2,340,73,86,54,32,61,19,0,0,0,0
01-09-2022,PrimeSeven,3,793,325,749,242,507,100,56,3,1,2,0
01-09-2022,ImpactTraining,3,872,627,401,66,335,98,22,89,68,21,9
01-09-2022,GrayPanthers,1,246,179,69,26,43,51,23,0,0,0,0
01-09-2022,PrimeSeven,2,309,30,20,13,7,92,21,72,28,44,4
01-09-2022,GrayPanthers,3,108,97,50,1,49,86,12,8,1,7,0
01-09-2022,Aurora,1,718,373,22,10,12,54,42,33,18,15,2
01-09-2022,GrayPanthers,1,293,106,60,0,60,60,4,56,38,18,5
01-09-2023,GrayPanthers,2,414,272,225,208,17,90,61,14,0,14,1
01-09-2023,Honeycomb,3,277,228,150,18,132,80,14,65,60,5,2
01-09-2023,BitterLaser,2,519,4,130,63,67,77,12,19,0,19,0
01-09-2023,Discovery,1,296,163,293,164,129,52,23,19,13,6,1
01-09-2023,ImpactTraining,1,652,368,362,67,295,75,24,68,39,29,9
01-09-2023,CelestialInterface,2,169,88,91,84,7,80,28,8,5,3,0
01-10-2021,Honeycomb,3,266,188,225,92,133,86,52,85,10,75,1
01-10-2021,ImpactTraining,2,895,322,449,397,52,79,53,28,5,23,0
01-10-2021,Quicksilver,2,247,163,171,62,109,55,16,8,2,6,0
01-10-2021,Aurora,2,338,118,0,0,0,89,33,12,5,7,0
01-10-2021,CelestialInterface,3,196,154,187,52,135,87,65,86,0,86,6
01-10-2021,PrimeSeven,3,323,300,26,12,14,81,16,79,60,19,6
01-10-2021,CelestialInterface,2,922,211,52,42,10,77,40,23,11,12,2
01-10-2021,Mustangs,2,643,229,357,334,23,68,45,50,22,28,2
01-10-2022,Mustangs,3,647,50,491,366,125,98,31,11,3,8,0
01-10-2022,Mustangs,2,783,696,327,244,83,65,29,56,34,22,7
01-10-2022,Quicksilver,1,360,134,214,125,89,81,55,76,5,71,5
01-10-2022,CelestialInterface,2,674,153,203,123,80,76,52,14,13,1,1
01-10-2022,Mustangs,1,960,519,794,679,115,99,34,8,0,8,0
01-10-2022,ImpactTraining,3,114,89,29,10,19,59,1,21,19,2,1
01-10-2022,CelestialInterface,2,853,115,541,322,219,60,41,8,5,3,0
01-10-2022,PrimeSeven,2,272,129,90,38,52,62,27,13,8,5,0
01-10-2022,Honeycomb,3,475,289,257,26,231,89,29,32,8,24,0
01-10-2022,Discovery,2,540,496,67,60,7,53,12,26,25,1,1
01-10-2022,CelestialInterface,3,121,109,96,51,45,85,10,58,34,24,7
01-10-2022,Aurora,1,298,198,197,96,101,67,1,35,19,16,1
01-10-2022,GrayPanthers,2,506,45,319,202,117,57,5,6,5,1,0
01-10-2022,ImpactTraining,2,871,790,797,458,339,97,91,40,1,39,1
01-10-2022,ImpactTraining,2,973,242,857,789,68,94,41,21,15,6,1
01-10-2022,Mustangs,1,927,231,117,74,43,92,3,20,0,20,0
01-10-2022,CelestialInterface,1,478,95,167,90,77,95,23,34,25,9,4
01-10-2023,Mustangs,3,492,166,138,45,93,58,12,57,10,47,7
01-10-2023,GrayPanthers,3,135,48,26,2,24,79,59,36,8,28,4
01-10-2023,Mustangs,3,948,149,839,610,229,87,77,3,2,1,0
01-10-2023,ImpactTraining,3,793,576,638,73,565,71,68,46,21,25,4
01-10-2023,Discovery,2,480,152,278,110,168,72,41,28,20,8,3
01-10-2023,BitterLaser,3,343,302,312,59,253,74,17,18,14,4,0
01-10-2023,BitterLaser,3,414,32,379,224,155,91,36,79,25,54,1
01-10-2023,GrayPanthers,3,619,616,378,135,243,81,38,25,15,10,1
01-10-2023,Mustangs,1,750,476,391,286,105,89,84,49,46,3,0
01-10-2023,GrayPanthers,2,142,101,94,45,49,73,8,71,48,23,1
01-10-2023,Discovery,3,406,244,144,69,75,74,8,36,0,36,1
01-11-2021,Discovery,1,606,123,68,19,49,54,6,20,12,8,0
01-11-2021,BitterLaser,1,722,716,1,0,1,66,53,40,14,26,2
01-11-2021,GrayPanthers,3,728,50,244,114,130,57,44,49,13,36,0
01-11-2021,Discovery,2,479,419,382,25,357,97,67,19,13,6,1
01-11-2021,Quicksilver,1,608,458,464,173,291,51,27,40,14,26,2
01-11-2021,GrayPanthers,3,919,853,323,86,237,59,24,18,14,4,1
01-11-2021,PrimeSeven,1,187,8,48,15,33,57,39,21,15,6,1
01-11-2022,CelestialInterface,2,511,205,467,304,163,93,72,28,7,21,1
01-11-2022,BitterLaser,2,850,713,472,14,458,88,59,63,1,62,0
01-11-2022,Discovery,3,892,759,556,332,224,69,24,45,2,43,3
01-11-2022,GrayPanthers,1,498,1,373,227,146,89,15,11,2,9,0
01-11-2022,Honeycomb,2,938,697,589,116,473,85,84,43,0,43,0
01-11-2022,PrimeSeven,2,583,24,27,5,22,60,39,19,17,2,1
01-11-2022,GrayPanthers,3,360,345,238,93,145,83,77,11,7,4,0
01-11-2022,GrayPanthers,1,326,60,13,5,8,93,53,14,12,2,0
01-11-2022,Discovery,2,211,61,69,49,20,85,39,38,17,21,4
01-11-2023,ImpactTraining,3,410,143,174,12,162,79,16,20,0,20,2
01-11-2023,Honeycomb,1,580,423,171,155,16,68,63,65,60,5,8
01-11-2023,Discovery,3,465,451,323,322,1,61,52,49,6,43,6
01-11-2023,Mustangs,3,302,210,258,50,208,60,58,9,0,9,0
01-11-2023,CelestialInterface,1,147,137,75,47,28,59,50,46,36,10,1
01-11-2023,GrayPanthers,1,878,268,646,43,603,77,30,54,53,1,1
01-11-2023,BitterLaser,1,680,157,164,22,142,98,42,17,16,1,0
01-11-2023,Mustangs,3,165,24,141,118,23,95,73,78,43,35,10
01-11-2023,CelestialInterface,1,354,342,92,4,88,92,26,27,10,17,1
01-12-2021,Mustangs,1,763,221,664,359,305,73,52,26,2,24,0
01-12-2021,CelestialInterface,2,207,113,120,98,22,95,47,69,59,10,7
01-12-2021,ImpactTraining,2,902,558,811,595,216,62,25,39,3,36,0
01-12-2021,Honeycomb,2,527,94,40,11,29,79,35,44,27,17,3
01-12-2021,CelestialInterface,2,100,49,45,31,14,86,49,19,5,14,1
01-12-2021,CelestialInterface,2,172,70,167,43,124,63,41,40,30,10,5
01-12-2022,Aurora,2,640,109,376,122,254,60,19,8,3,5,0
01-12-2022,BitterLaser,3,635,234,556,74,482,56,28,8,6,2,0
01-12-2022,Quicksilver,3,314,218,231,133,98,69,46,1,0,1,0
01-12-2022,PrimeSeven,2,632,273,542,536,6,71,23,16,15,1,0
01-12-2022,PrimeSeven,2,393,333,89,48,41,98,26,18,5,13,0
01-12-2022,PrimeSeven,3,751,102,69,62,7,98,23,96,54,42,4
01-12-2022,Quicksilver,3,178,13,142,55,87,83,45,76,60,16,3
01-12-2023,PrimeSeven,3,820,473,521,497,24,96,1,34,0,34,1
01-12-2023,ImpactTraining,3,206,23,29,25,4,55,0,47,8,39,1
01-12-2023,Discovery,3,627,625,53,22,31,64,31,21,3,18,2
01-12-2023,Quicksilver,2,909,409,163,43,120,56,31,54,13,41,3
01-12-2023,Aurora,1,830,367,563,416,147,87,70,77,22,55,5
01-12-2023,Honeycomb,3,705,687,614,359,255,50,33,35,33,2,3
02-01-2021,Discovery,1,450,121,309,101,208,64,23,4,0,4,0
02-01-2021,GrayPanthers,2,106,25,13,6,7,78,50,41,22,19,2
02-01-2021,ImpactTraining,1,220,8,212,107,105,96,65,47,7,40,5
02-01-2021,CelestialInterface,3,900,285,589,270,319,77,39,17,5,12,1
02-01-2021,GrayPanthers,1,276,35,66,65,1,58,4,2,0,2,0
02-01-2021,Discovery,1,419,29,140,2,138,58,19,36,23,13,3
02-01-2021,Discovery,2,820,537,606,137,469,71,2,39,32,7,1
02-01-2021,GrayPanthers,3,418,214,110,50,60,70,52,14,9,5,0
02-01-2021,ImpactTraining,3,447,367,375,208,167,95,68,9,4,5,0
02-01-2021,PrimeSeven,1,508,235,163,39,124,63,42,23,0,23,1
02-01-2021,CelestialInterface,2,428,347,235,168,67,57,56,29,13,16,3
02-01-2021,Discovery,3,861,552,770,30,740,89,72,61,34,27,2
02-01-2022,Mustangs,2,491,354,443,410,33,87,3,46,33,13,0
02-01-2022,GrayPanthers,1,850,511,847,371,476,87,85,17,16,1,1
02-01-2022,CelestialInterface,1,135,60,91,8,83,68,7,34,31,3,3
02-01-2022,PrimeSeven,2,433,416,193,126,67,56,19,2,1,1,0
02-01-2023,CelestialInterface,3,552,497,273,264,9,74,24,49,17,32,4
02-01-2023,ImpactTraining,2,871,77,476,17,459,93,13,47,6,41,6
02-01-2023,Aurora,1,312,225,254,126,128,70,50,43,9,34,2
02-01-2023,GrayPanthers,3,817,62,624,56,568,92,24,22,4,18,0
02-01-2023,Quicksilver,2,325,219,79,24,55,71,21,58,10,48,0
02-01-2023,Aurora,2,211,151,185,154,31,69,36,55,22,33,1
02-01-2023,Honeycomb,2,977,110,117,32,85,67,49,41,14,27,4
02-01-2023,Quicksilver,3,530,477,74,62,12,92,27,2,1,1,0
02-01-2023,Mustangs,1,298,172,172,122,50,91,11,6,5,1,0
02-02-2021,PrimeSeven,2,341,244,248,225,23,80,11,29,19,10,0
02-02-2021,Quicksilver,1,210,39,105,64,41,54,6,1,0,1,0
02-02-2021,GrayPanthers,2,678,281,165,157,8,77,52,17,16,1,0
02-02-2021,PrimeSeven,1,195,120,170,85,85,91,7,25,10,15,0
02-02-2021,BitterLaser,2,593,200,193,43,150,55,45,20,2,18,0
02-02-2021,ImpactTraining,1,173,154,81,42,39,52,24,2,0,2,0
02-02-2021,Discovery,2,944,589,525,384,141,53,45,17,12,5,0
02-02-2021,Aurora,3,994,888,239,84,155,79,56,72,13,59,5
02-02-2022,CelestialInterface,1,655,400,414,9,405,94,15,34,29,5,4
02-02-2022,Aurora,2,984,868,133,70,63,85,63,50,49,1,3
02-02-2022,Quicksilver,3,373,83,4,3,1,78,54,0,0,0,0
02-02-2022,GrayPanthers,2,644,376,383,128,255,100,76,82,34,48,11
02-02-2022,Honeycomb,1,266,133,29,17,12,70,25,54,53,1,1
02-02-2022,Mustangs,1,179,112,16,8,8,84,10,80,61,19,10
02-02-2022,ImpactTraining,3,727,688,202,56,146,92,66,25,16,9,0
02-02-2022,BitterLaser,1,533,522,265,190,75,84,35,61,5,56,0
02-02-2022,Mustangs,2,206,10,93,43,50,53,3,8,5,3,0
02-02-2023,Discovery,3,477,336,339,62,277,67,54,54,48,6,5
02-02-2023,ImpactTraining,2,543,307,113,59,54,65,17,36,0,36,0
02-02-2023,PrimeSeven,1,447,347,409,119,290,60,26,57,12,45,2
02-02-2023,BitterLaser,1,857,582,481,202,279,59,11,40,2,38,2
02-02-2023,Quicksilver,2,752,116,631,256,375,64,10,31,26,5,0
02-02-2023,BitterLaser,1,558,301,513,63,450,97,75,63,26,37,4
02-02-2023,Aurora,3,473,27,360,192,168,95,30,26,18,8,1
02-02-2023,Mustangs,3,886,216,131,45,86,74,1,21,8,13,1
02-02-2023,CelestialInterface,1,956,590,151,11,140,57,24,7,0,7,0
02-02-2023,Honeycomb,3,533,492,454,152,302,76,25,38,11,27,1
02-02-2023,ImpactTraining,2,804,352,460,193,267,90,82,13,4,9,0
02-03-2021,Discovery,2,465,448,248,8,240,79,48,16,14,2,1
02-03-2021,Honeycomb,2,903,311,742,653,89,56,11,17,3,14,1
02-03-2021,PrimeSeven,3,930,647,753,468,285,95,93,4,2,2,0
02-03-2021,Discovery,2,984,368,300,250,50,61,35,7,5,2,0
02-03-2021,PrimeSeven,2,971,473,2,1,1,64,63,2,1,1,0
02-03-2021,BitterLaser,3,696,475,420,362,58,77,66,49,17,32,6
02-03-2021,PrimeSeven,2,356,96,95,92,3,58,43,21,2,19,1
02-03-2021,BitterLaser,3,637,30,329,215,114,69,2,13,1,12,0
02-03-2021,CelestialInterface,2,725,16,416,200,216,84,20,50,41,9,2
02-03-2021,CelestialInterface,2,610,335,584,36,548,52,2,45,3,42,5
02-03-2021,Honeycomb,2,604,264,9,6,3,99,64,69,12,57,0
02-03-2021,Mustangs,1,501,221,70,61,9,83,77,64,54,10,3
02-03-2021,Honeycomb,1,957,716,299,26,273,96,18,47,43,4,0
02-03-2021,Aurora,1,505,181,395,364,31,58,32,40,18,22,5
02-03-2021,Honeycomb,2,538,266,45,6,39,52,3,1,0,1,0
02-03-2022,Mustangs,2,601,544,339,111,228,97,56,12,2,10,0
02-03-2022,BitterLaser,1,416,208,359,192,167,55,47,12,5,7,0
02-03-2022,BitterLaser,1,274,235,2,1,1,84,45,60,29,31,8
02-03-2022,PrimeSeven,1,890,3,211,115,96,61,28,53,37,16,3
02-03-2022,CelestialInterface,2,901,339,435,239,196,60,2,30,17,13,1
02-03-2022,CelestialInterface,2,342,335,80,39,41,93,62,73,1,72,0
02-03-2022,Quicksilver,1,264,9,224,22,202,72,22,29,5,24,1
02-03-2022,BitterLaser,2,952,670,446,24,422,77,55,6,3,3,0
02-03-2022,Mustangs,1,567,31,419,148,271,57,37,4,0,4,0
02-03-2023,ImpactTraining,1,103,69,94,25,69,72,54,23,6,17,2
02-03-2023,PrimeSeven,1,381,251,319,205,114,71,33,36,18,18,2
02-03-2023,CelestialInterface,3,839,251,596,568,28,84,46,37,10,27,3
02-03-2023,Aurora,2,372,171,256,141,115,68,47,20,7,13,1
02-03-2023,ImpactTraining,3,938,801,684,238,446,92,74,48,7,41,3
02-03-2023,Aurora,2,873,406,207,201,6,97,89,35,33,2,3
02-03-2023,BitterLaser,1,874,720,331,54,277,76,41,49,12,37,6
02-04-2021,GrayPanthers,1,155,119,118,87,31,59,18,33,11,22,3
02-04-2021,CelestialInterface,3,781,672,152,32,120,88,20,6,3,3,0
02-04-2021,GrayPanthers,3,986,679,468,377,91,70,63,48,42,6,1
02-04-2022,PrimeSeven,3,966,593,922,391,531,90,2,18,14,4,0
02-04-2022,Discovery,1,206,59,63,53,10,89,75,6,5,1,0
02-04-2022,Honeycomb,1,860,653,324,1,323,64,8,39,11,28,2
02-04-2022,Quicksilver,1,322,316,87,19,68,100,51,31,6,25,0
02-04-2022,Quicksilver,2,775,503,214,144,70,56,48,41,36,5,0
02-04-2022,CelestialInterface,1,193,120,74,42,32,98,16,32,16,16,2
02-04-2022,PrimeSeven,2,426,139,388,202,186,90,4,26,12,14,2
02-04-2022,CelestialInterface,1,917,755,207,75,132,59,1,31,30,1,3
02-04-2022,Mustangs,2,714,287,185,112,73,64,20,33,21,12,3
02-04-2022,Aurora,3,437,223,270,154,116,68,37,62,40,22,4
02-04-2022,Honeycomb,1,931,470,575,176,399,63,26,28,18,10,3
02-04-2023,Aurora,1,162,95,19,12,7,76,14,25,14,11,1
02-04-2023,Quicksilver,2,287,92,203,133,70,93,13,25,3,22,2
02-04-2023,GrayPanthers,3,761,28,11,4,7,97,92,6,4,2,0
02-04-2023,Honeycomb,3,478,11,12,2,10,74,60,69,8,61,2
02-04-2023,BitterLaser,2,997,335,281,10,271,79,75,26,14,12,2
02-04-2023,GrayPanthers,1,301,63,49,44,5,65,53,62,53,9,3
02-04-2023,CelestialInterface,2,999,129,930,647,283,93,42,12,3,9,0
02-04-2023,PrimeSeven,1,863,289,399,334,65,84,51,20,6,14,2
02-05-2021,ImpactTraining,1,131,76,124,15,109,76,64,41,39,2,3
02-05-2021,Discovery,1,187,160,184,5,179,75,53,35,4,31,4
02-05-2021,CelestialInterface,3,185,98,153,94,59,99,20,28,18,10,1
02-05-2021,Aurora,1,758,206,241,173,68,60,30,30,4,26,0
02-05-2021,BitterLaser,2,604,281,523,360,163,62,57,34,7,27,2
02-05-2021,GrayPanthers,3,709,488,114,9,105,99,6,10,2,8,0
02-05-2021,Quicksilver,2,271,204,173,140,33,59,12,25,12,13,2
02-05-2021,Honeycomb,3,140,30,97,70,27,78,36,19,1,18,0
02-05-2022,PrimeSeven,1,967,223,427,245,182,60,36,26,0,26,2
02-05-2022,PrimeSeven,2,682,455,584,568,16,94,12,68,31,37,1
02-05-2022,ImpactTraining,3,433,376,268,125,143,58,5,3,0,3,0
02-05-2022,Honeycomb,2,505,143,503,408,95,86,67,48,3,45,0
02-05-2022,Honeycomb,1,471,181,162,70,92,86,0,1,0,1,0
02-05-2022,CelestialInterface,2,179,91,27,21,6,100,69,34,17,17,2
02-05-2022,GrayPanthers,2,151,6,142,124,18,67,23,65,60,5,8
02-05-2022,Aurora,3,438,26,143,21,122,57,46,14,4,10,0
02-05-2022,Quicksilver,3,898,545,470,453,17,75,34,33,6,27,1
02-05-2022,Quicksilver,1,507,167,186,7,179,59,37,20,3,17,2
02-05-2022,GrayPanthers,2,359,131,208,180,28,92,34,15,6,9,1
02-05-2022,CelestialInterface,2,397,312,65,57,8,83,32,58,55,3,7
02-05-2023,BitterLaser,1,669,210,418,211,207,62,2,51,6,45,0
02-05-2023,PrimeSeven,2,313,72,142,62,80,91,57,29,11,18,3
02-05-2023,Honeycomb,1,937,559,253,167,86,87,42,16,11,5,0
02-05-2023,CelestialInterface,3,449,140,73,33,40,77,0,68,23,45,3
02-05-2023,CelestialInterface,2,611,78,476,34,442,75,67,20,14,6,0
02-05-2023,Quicksilver,3,713,502,327,326,1,81,5,8,2,6,0
02-05-2023,ImpactTraining,3,583,332,51,35,16,80,15,23,7,16,0
02-05-2023,GrayPanthers,1,415,370,399,181,218,54,52,30,18,12,2
02-05-2023,Aurora,2,416,172,194,117,77,71,67,26,6,20,1
02-05-2023,Honeycomb,1,900,843,667,362,305,59,15,45,13,32,5
02-05-2023,ImpactTraining,1,994,815,639,228,411,94,93,88,70,18,7
02-05-2023,PrimeSeven,2,908,685,628,33,595,79,59,43,24,19,5
02-05-2023,ImpactTraining,1,173,43,54,3,51,80,11,73,49,24,3
02-05-2023,PrimeSeven,1,151,35,63,16,47,91,28,87,58,29,9
02-06-2021,PrimeSeven,1,619,504,556,319,237,76,51,55,9,46,0
02-06-2021,CelestialInterface,3,596,456,218,87,131,54,11,47,34,13,2
02-06-2021,CelestialInterface,1,863,794,308,194,114,86,53,39,3,36,4
02-06-2021,Mustangs,3,489,102,341,111,230,80,30,42,28,14,5
02-06-2021,Mustangs,3,859,774,0,0,0,85,25,54,13,41,5
02-06-2021,PrimeSeven,1,581,501,176,82,94,59,14,11,8,3,0
02-06-2021,ImpactTraining,3,387,318,316,116,200,83,75,75,72,3,2
02-06-2021,BitterLaser,1,194,140,131,52,79,81,47,54,51,3,0
02-06-2021,Quicksilver,1,176,122,34,33,1,79,28,47,28,19,2
02-06-2022,Quicksilver,3,945,188,826,392,434,78,2,16,2,14,0
02-06-2022,Aurora,2,405,209,372,54,318,52,24,12,8,4,0
02-06-2022,Mustangs,1,486,261,192,0,192,71,46,33,4,29,0
02-06-2022,Quicksilver,3,752,606,25,23,2,89,32,39,24,15,3
02-06-2022,Aurora,3,745,251,125,33,92,87,6,31,15,16,2
02-06-2022,CelestialInterface,1,696,645,308,203,105,50,16,15,10,5,1
02-06-2022,Honeycomb,2,359,160,107,104,3,74,47,54,51,3,6
02-06-2022,BitterLaser,2,248,149,6,4,2,65,30,5,3,2,0
02-06-2022,CelestialInterface,2,671,366,418,150,268,63,50,54,34,20,1
02-06-2022,GrayPanthers,1,922,164,503,295,208,100,97,93,92,1,0
02-06-2022,Aurora,1,964,196,696,422,274,84,43,9,4,5,0
02-06-2022,GrayPanthers,2,833,816,831,689,142,84,8,5,4,1,0
02-06-2022,Quicksilver,2,382,23,302,24,278,65,7,62,59,3,1
02-06-2022,Honeycomb,3,320,47,178,155,23,73,59,72,46,26,5
02-06-2023,CelestialInterface,2,812,631,580,28,552,81,63,4,0,4,0
02-06-2023,Honeycomb,2,470,254,162,89,73,66,31,1,0,1,0
02-06-2023,Discovery,3,785,763,668,284,384,95,49,7,3,4,0
02-06-2023,Aurora,3,430,260,320,84,236,73,25,32,6,26,0
02-06-2023,Aurora,2,902,147,354,66,288,62,47,15,9,6,0
02-06-2023,PrimeSeven,1,819,540,520,472,48,66,21,38,0,38,4
02-06-2023,BitterLaser,3,977,509,820,620,200,50,21,11,4,7,0
02-07-2021,BitterLaser,1,782,118,357,189,168,73,55,20,8,12,0
02-07-2021,Discovery,3,376,240,321,290,31,91,13,13,5,8,0
02-07-2021,BitterLaser,1,515,475,508,371,137,93,2,42,14,28,1
02-07-2021,BitterLaser,2,422,387,213,16,197,71,27,44,9,35,2
02-07-2021,GrayPanthers,3,331,55,123,58,65,80,76,43,6,37,3
02-07-2021,Aurora,1,212,159,39,9,30,68,2,10,7,3,0
02-07-2021,Aurora,3,226,82,218,213,5,76,39,8,1,7,0
02-07-2021,Mustangs,1,710,700,86,53,33,61,42,10,5,5,0
02-07-2021,CelestialInterface,2,212,134,35,3,32,78,71,19,4,15,1
02-07-2021,Aurora,3,476,308,46,34,12,93,75,33,1,32,3
02-07-2021,Honeycomb,1,435,210,313,215,98,87,14,31,2,29,3
02-07-2021,Discovery,2,944,9,62,22,40,64,7,19,18,1,0
02-07-2021,CelestialInterface,2,999,801,137,52,85,97,84,38,37,1,0
02-07-2021,GrayPanthers,2,469,50,439,347,92,96,45,9,7,2,0
02-07-2021,Aurora,1,202,175,68,38,30,98,69,76,7,69,7
02-07-2022,Honeycomb,1,197,180,143,29,114,58,36,50,11,39,3
02-07-2022,CelestialInterface,2,851,675,182,57,125,85,60,55,21,34,5
02-07-2022,BitterLaser,1,697,513,618,540,78,59,19,0,0,0,0
02-07-2022,Aurora,3,750,551,54,30,24,82,34,13,6,7,0
02-07-2022,Honeycomb,3,815,396,496,224,272,86,57,47,13,34,5
02-07-2022,Aurora,3,764,500,110,62,48,96,38,60,36,24,2
02-07-2022,Discovery,1,623,29,252,219,33,64,26,24,12,12,1
02-07-2022,Mustangs,2,795,489,112,35,77,59,47,10,5,5,0
02-07-2022,Aurora,1,786,1,103,82,21,64,51,49,21,28,2
02-07-2022,ImpactTraining,2,998,917,435,348,87,88,26,30,1,29,1
02-07-2022,ImpactTraining,1,204,41,6,5,1,86,71,10,9,1,0
02-07-2022,GrayPanthers,2,125,31,7,0,7,87,41,25,9,16,0
02-07-2022,Honeycomb,3,791,761,475,105,370,86,18,47,22,25,4
02-07-2023,CelestialInterface,3,939,124,645,488,157,54,34,1,0,1,0
02-07-2023,Honeycomb,3,528,331,37,28,9,64,60,2,1,1,0
02-07-2023,Aurora,1,871,212,415,219,196,91,75,18,17,1,1
02-07-2023,PrimeSeven,1,629,244,211,101,110,50,43,21,7,14,0
02-07-2023,Honeycomb,1,181,115,33,28,5,69,47,12,4,8,0
02-07-2023,Quicksilver,2,582,273,295,186,109,50,25,46,31,15,0
02-07-2023,PrimeSeven,2,793,2,168,90,78,83,35,78,1,77,9
02-07-2023,Discovery,3,312,151,230,223,7,96,57,78,31,47,0
02-07-2023,ImpactTraining,1,293,282,145,129,16,100,11,26,14,12,2
02-07-2023,GrayPanthers,2,776,729,445,41,404,63,54,21,15,6,1
02-08-2021,GrayPanthers,3,381,30,66,46,20,57,55,52,46,6,5
02-08-2021,Discovery,3,426,107,12,10,2,98,51,92,2,90,3
02-08-2021,Mustangs,1,914,536,600,12,588,91,77,81,18,63,8
02-08-2021,PrimeSeven,3,709,210,319,304,15,88,8,70,1,69,9
02-08-2021,ImpactTraining,1,859,362,0,0,0,96,81,83,59,24,10
02-08-2021,BitterLaser,3,765,728,698,543,155,70,18,53,25,28,5
02-08-2021,Aurora,3,513,487,335,158,177,85,76,30,9,21,1
02-08-2021,Honeycomb,3,932,868,719,270,449,96,35,89,29,60,2
02-08-2022,BitterLaser,3,395,248,168,94,74,55,39,9,6,3,0
02-08-2022,Honeycomb,2,978,634,948,847,101,64,32,13,4,9,0
02-08-2022,Discovery,3,310,266,137,40,97,75,52,62,11,51,0
02-08-2022,GrayPanthers,3,157,151,46,1,45,59,32,41,40,1,0
02-08-2022,BitterLaser,1,453,234,132,59,73,56,55,41,37,4,5
02-08-2022,Discovery,1,807,455,456,188,268,76,28,40,3,37,5
02-08-2022,GrayPanthers,3,420,345,102,41,61,70,44,25,0,25,1
02-08-2022,Mustangs,3,858,598,458,139,319,100,65,86,41,45,0
02-08-2023,CelestialInterface,1,547,65,175,134,41,89,30,33,12,21,3
02-08-2023,Discovery,3,295,236,175,161,14,62,20,40,5,35,3
02-08-2023,BitterLaser,1,469,30,231,86,145,74,9,62,52,10,0
02-08-2023,BitterLaser,3,448,434,244,183,61,63,15,22,17,5,1
02-09-2021,GrayPanthers,2,660,410,75,52,23,55,39,25,0,25,0
02-09-2021,PrimeSeven,1,522,223,159,45,114,97,59,42,17,25,3
02-09-2021,Quicksilver,2,684,106,379,135,244,66,38,27,6,21,3
02-09-2021,GrayPanthers,3,666,531,492,67,425,62,8,52,11,41,3
02-09-2021,Mustangs,2,692,669,114,61,53,91,38,23,8,15,0
02-09-2021,BitterLaser,1,258,257,201,38,163,83,35,12,8,4,0
02-09-2021,Honeycomb,1,589,172,65,13,52,57,39,18,17,1,0
02-09-2021,Mustangs,3,164,15,105,95,10,98,48,1,0,1,0
02-09-2021,Mustangs,1,473,50,190,99,91,58,9,26,8,18,1
02-09-2022,Mustangs,1,913,393,111,81,30,80,34,3,0,3,0
02-09-2022,Quicksilver,3,130,46,27,11,16,94,82,86,84,2,10
02-09-2022,BitterLaser,2,339,182,164,24,140,60,28,53,38,15,4
02-09-2023,BitterLaser,2,119,6,27,7,20,99,90,72,18,54,8
02-09-2023,BitterLaser,2,564,426,158,73,85,51,46,23,6,17,0
02-09-2023,GrayPanthers,1,403,101,297,20,277,81,55,30,14,16,2
02-09-2023,Mustangs,2,101,43,35,1,34,81,78,66,6,60,7
02-09-2023,BitterLaser,3,219,89,103,98,5,62,50,16,6,10,0
02-09-2023,CelestialInterface,2,172,4,56,18,38,97,57,84,66,18,6
02-09-2023,Quicksilver,1,806,626,140,103,37,73,1,68,58,10,6
02-09-2023,ImpactTraining,3,935,690,202,93,109,90,47,5,3,2,0
02-10-2021,GrayPanthers,3,301,178,87,53,34,87,36,51,16,35,2
02-10-2021,Quicksilver,1,553,409,204,154,50,93,60,66,48,18,1
02-10-2021,Discovery,3,710,47,119,93,26,78,13,66,37,29,3
02-10-2021,Discovery,3,499,94,128,123,5,61,12,58,15,43,7
02-10-2021,ImpactTraining,2,446,395,406,365,41,95,41,52,19,33,0
02-10-2021,BitterLaser,2,476,385,385,79,306,57,11,44,25,19,3
02-10-2021,ImpactTraining,2,448,79,404,362,42,83,74,58,16,42,1
02-10-2021,GrayPanthers,1,317,51,120,58,62,78,36,54,29,25,2
02-10-2021,Aurora,1,418,273,276,3,273,88,50,20,5,15,2
02-10-2021,Mustangs,3,976,326,338,299,39,72,40,64,29,35,6
02-10-2022,GrayPanthers,1,730,19,310,186,124,53,13,52,18,34,1
02-10-2022,ImpactTraining,1,956,639,337,241,96,63,62,54,2,52,3
02-10-2022,Discovery,1,877,273,419,15,404,97,80,27,25,2,2
02-10-2022,Discovery,1,337,267,72,38,34,68,24,10,1,9,0
02-10-2022,Aurora,1,629,613,457,358,99,95,51,90,23,67,0
02-10-2022,ImpactTraining,3,805,17,353,21,332,68,8,7,4,3,0
02-10-2022,PrimeSeven,2,544,193,67,44,23,82,25,66,0,66,1
02-10-2022,Honeycomb,1,777,628,504,235,269,75,24,15,14,1,0
02-10-2022,PrimeSeven,2,274,230,194,178,16,57,51,40,13,27,0
02-10-2022,Discovery,1,590,559,435,344,91,57,56,26,13,13,0
02-10-2023,Honeycomb,2,247,166,76,45,31,68,57,8,1,7,0
02-10-2023,CelestialInterface,3,529,138,168,54,114,93,36,27,21,6,0
02-10-2023,CelestialInterface,1,303,200,260,156,104,67,20,28,13,15,0
02-10-2023,GrayPanthers,1,245,228,143,6,137,58,23,41,6,35,3
02-10-2023,GrayPanthers,3,187,24,145,122,23,87,11,86,20,66,10
02-10-2023,Honeycomb,3,444,52,332,189,143,91,0,39,25,14,3
02-10-2023,Aurora,1,225,216,140,8,132,70,61,44,40,4,2
02-10-2023,PrimeSeven,3,958,267,311,308,3,85,59,23,1,22,1
02-11-2021,BitterLaser,2,837,64,372,251,121,76,43,8,0,8,0
02-11-2021,GrayPanthers,2,594,198,98,41,57,99,94,58,10,48,5
02-11-2021,Quicksilver,2,494,174,486,146,340,79,71,77,55,22,1
02-11-2021,ImpactTraining,2,257,84,214,45,169,71,58,37,13,24,0
02-11-2021,Aurora,1,872,782,213,54,159,75,9,30,11,19,3
02-11-2021,Aurora,2,960,334,916,769,147,79,52,70,68,2,6
02-11-2022,PrimeSeven,1,536,212,195,25,170,57,20,1,0,1,0
02-11-2022,GrayPanthers,2,367,263,203,117,86,94,82,17,9,8,0
02-11-2022,Aurora,1,509,438,307,132,175,89,9,58,39,19,0
02-11-2022,CelestialInterface,1,168,60,158,122,36,68,62,36,12,24,2
02-11-2022,ImpactTraining,3,112,108,31,1,30,72,5,20,11,9,2
02-11-2022,Discovery,1,401,152,259,173,86,96,43,20,17,3,1
02-11-2023,BitterLaser,3,630,627,482,169,313,66,49,27,21,6,0
02-11-2023,BitterLaser,1,852,350,601,269,332,51,16,47,0,47,1
02-11-2023,Aurora,3,992,831,818,348,470,81,36,40,23,17,3
02-11-2023,Quicksilver,1,627,329,501,153,348,51,50,23,12,11,1
02-11-2023,Honeycomb,3,651,378,553,264,289,50,33,48,16,32,0
02-11-2023,Mustangs,1,583,82,14,2,12,95,49,7,6,1,0
02-11-2023,Discovery,1,939,326,304,267,37,87,7,24,0,24,1
02-12-2021,Quicksilver,2,305,122,288,92,196,74,55,1,0,1,0
02-12-2021,BitterLaser,2,841,397,246,236,10,61,57,35,29,6,0
02-12-2021,CelestialInterface,1,356,30,162,46,116,64,51,59,54,5,2
02-12-2021,ImpactTraining,2,415,75,98,34,64,81,58,16,14,2,0
02-12-2021,ImpactTraining,1,720,391,33,11,22,58,26,46,16,30,5
02-12-2021,PrimeSeven,1,381,342,276,275,1,58,25,8,4,4,0
02-12-2021,GrayPanthers,1,627,168,10,3,7,93,79,48,16,32,4
02-12-2021,BitterLaser,2,270,159,144,99,45,100,52,57,10,47,1
02-12-2022,BitterLaser,3,299,195,96,35,61,81,34,63,61,2,4
02-12-2022,BitterLaser,3,455,21,277,65,212,78,77,0,0,0,0
02-12-2022,Mustangs,3,283,68,14,5,9,71,18,53,1,52,6
02-12-2022,Aurora,1,758,178,291,166,125,96,90,47,41,6,2
02-12-2022,PrimeSeven,2,668,655,428,159,269,52,50,32,28,4,0
02-12-2022,BitterLaser,1,846,610,204,109,95,52,10,27,25,2,3
02-12-2022,GrayPanthers,2,577,153,2,1,1,59,30,39,12,27,1
02-12-2023,Quicksilver,3,191,147,110,82,28,85,19,81,51,30,10
02-12-2023,Mustangs,3,219,25,30,27,3,68,24,19,8,11,1
02-12-2023,Mustangs,3,208,73,120,7,113,71,39,50,48,2,5
02-12-2023,Honeycomb,2,828,496,47,40,7,64,21,37,17,20,4
02-12-2023,BitterLaser,1,377,13,339,75,264,65,49,57,8,49,5
02-12-2023,Honeycomb,1,674,653,631,187,444,73,6,1,0,1,0
02-12-2023,BitterLaser,3,945,330,894,564,330,94,81,65,2,63,7
02-12-2023,Discovery,1,675,130,25,20,5,85,30,8,6,2,0
02-12-2023,GrayPanthers,2,922,676,751,20,731,88,87,44,1,43,1
03-01-2021,Mustangs,1,948,548,133,3,130,61,55,36,5,31,1
03-01-2021,ImpactTraining,1,191,29,102,101,1,88,47,74,62,12,6
03-01-2021,ImpactTraining,3,191,153,112,57,55,76,67,55,26,29,4
03-01-2021,Discovery,2,315,51,13,1,12,94,89,85,40,45,6
03-01-2021,BitterLaser,1,315,248,264,15,249,99,9,7,6,1,0
03-01-2021,ImpactTraining,3,656,110,464,44,420,52,41,37,27,10,4
03-01-2021,ImpactTraining,2,243,152,56,4,52,71,22,59,30,29,7
03-01-2022,CelestialInterface,1,164,17,109,77,32,86,12,48,32,16,5
03-01-2022,BitterLaser,1,684,524,150,5,145,84,25,64,55,9,0
03-01-2022,Mustangs,2,400,297,98,53,45,94,88,28,2,26,1
03-01-2022,Quicksilver,3,671,516,221,106,115,58,33,38,23,15,3
03-01-2022,ImpactTraining,1,400,11,244,159,85,97,78,85,16,69,5
03-01-2022,BitterLaser,1,143,83,69,61,8,72,49,10,4,6,0
03-01-2022,Aurora,1,270,195,233,223,10,71,37,62,3,59,7
03-01-2022,Aurora,3,393,220,197,11,186,53,29,46,26,20,4
03-01-2022,Honeycomb,1,931,466,550,502,48,71,38,60,41,19,8
03-01-2022,ImpactTraining,3,300,218,63,41,22,85,23,81,19,62,2
03-01-2022,ImpactTraining,1,408,14,266,144,122,92,7,56,55,1,4
03-01-2023,PrimeSeven,3,965,777,390,3,387,94,10,52,27,25,1
03-01-2023,Discovery,2,223,47,60,50,10,66,3,65,31,34,0
03-01-2023,Quicksilver,1,452,152,301,32,269,92,64,11,10,1,0
03-01-2023,CelestialInterface,3,330,298,327,126,201,79,14,13,10,3,0
03-01-2023,GrayPanthers,3,652,564,541,328,213,83,70,23,13,10,2
03-01-2023,ImpactTraining,1,930,803,751,710,41,79,27,7,5,2,0
03-01-2023,ImpactTraining,2,420,134,23,9,14,70,12,13,10,3,0
03-01-2023,Discovery,1,764,460,24,11,13,70,55,63,1,62,6
03-02-2021,BitterLaser,3,268,89,261,75,186,73,11,9,5,4,0
03-02-2021,Mustangs,1,734,472,113,109,4,69,63,66,25,41,0
03-02-2021,CelestialInterface,1,278,240,150,60,90,95,73,72,18,54,7
03-02-2021,PrimeSeven,2,394,21,245,174,71,60,6,44,12,32,4
03-02-2021,Mustangs,1,644,584,567,222,345,82,78,56,36,20,3
03-02-2021,ImpactTraining,1,119,16,62,11,51,77,51,2,0,2,0
03-02-2021,ImpactTraining,2,714,82,597,547,50,99,36,88,50,38,1
03-02-2021,BitterLaser,3,257,163,19,11,8,88,8,75,29,46,0
03-02-2022,Discovery,1,894,683,671,364,307,56,53,4,3,1,0
03-02-2022,Quicksilver,1,904,101,550,260,290,73,6,49,38,11,1
03-02-2022,PrimeSeven,1,831,390,219,21,198,98,73,9,4,5,0
03-02-2022,CelestialInterface,3,588,149,201,90,111,95,42,67,18,49,2
03-02-2022,GrayPanthers,2,605,30,325,3,322,93,18,25,19,6,1
03-02-2022,Quicksilver,3,369,231,19,7,12,57,40,38,32,6,0
03-02-2022,CelestialInterface,2,873,85,24,6,18,92,45,20,10,10,2
03-02-2022,Honeycomb,1,811,581,745,186,559,57,3,36,11,25,3
03-02-2022,Aurora,2,875,466,861,733,128,56,39,15,10,5,0
03-02-2023,Quicksilver,2,280,10,140,33,107,59,43,1,0,1,0
03-02-2023,CelestialInterface,1,862,621,789,534,255,92,50,51,44,7,3
03-02-2023,BitterLaser,1,140,55,77,45,32,67,0,45,30,15,3
03-02-2023,GrayPanthers,3,512,114,146,137,9,68,7,63,45,18,5
03-02-2023,Aurora,1,597,59,390,311,79,92,65,28,15,13,2
03-02-2023,Discovery,3,508,54,506,477,29,62,9,3,1,2,0
03-02-2023,PrimeSeven,1,727,79,235,216,19,75,16,48,26,22,5
03-02-2023,Aurora,3,802,615,120,66,54,63,34,56,12,44,0
03-02-2023,PrimeSeven,2,879,124,42,28,14,89,11,82,61,21,2
03-02-2023,Honeycomb,1,375,23,195,45,150,53,39,23,22,1,1
03-02-2023,Honeycomb,3,462,32,221,148,73,57,4,15,10,5,0
03-02-2023,Honeycomb,1,573,146,515,370,145,78,31,49,42,7,0
03-02-2023,BitterLaser,1,100,61,88,36,52,93,71,74,40,34,10
03-03-2021,GrayPanthers,1,844,363,643,464,179,77,51,12,2,10,0
03-03-2021,Aurora,2,948,711,238,44,194,54,23,30,23,7,1
03-03-2021,CelestialInterface,2,478,36,20,9,11,98,96,11,1,10,0
03-03-2021,Honeycomb,2,813,297,233,198,35,89,52,58,47,11,1
03-03-2021,Quicksilver,3,313,2,118,84,34,61,40,10,3,7,0
03-03-2021,Aurora,3,714,216,374,275,99,60,51,4,2,2,0
03-03-2022,Aurora,3,580,63,468,237,231,56,13,22,3,19,0
03-03-2022,Honeycomb,1,792,738,95,34,61,96,71,45,34,11,1
03-03-2022,Honeycomb,1,992,890,889,462,427,86,79,33,24,9,0
03-03-2022,Aurora,3,139,86,55,3,52,90,16,5,4,1,0
03-03-2022,ImpactTraining,3,803,764,321,213,108,54,49,10,6,4,0
03-03-2022,PrimeSeven,3,605,585,484,192,292,96,93,68,24,44,6
03-03-2022,Honeycomb,3,928,642,194,122,72,98,31,89,9,80,6
03-03-2022,Discovery,2,494,42,221,98,123,81,36,35,15,20,0
03-03-2022,Quicksilver,2,124,40,20,19,1,93,2,49,31,18,3
03-03-2022,Quicksilver,1,265,32,221,193,28,86,67,71,34,37,4
03-03-2023,Quicksilver,1,423,81,53,38,15,77,21,56,41,15,0
03-03-2023,BitterLaser,3,462,148,266,243,23,75,48,9,1,8,0
03-03-2023,BitterLaser,1,479,171,395,301,94,71,46,65,48,17,5
03-03-2023,Aurora,1,314,127,63,18,45,92,62,73,6,67,2
03-03-2023,Discovery,3,241,205,102,25,77,56,33,18,1,17,0
03-03-2023,Discovery,3,855,448,266,153,113,51,19,35,11,24,4
03-03-2023,PrimeSeven,3,124,4,48,28,20,59,32,44,18,26,5
03-03-2023,Discovery,1,639,215,384,383,1,98,90,39,18,21,1
03-03-2023,CelestialInterface,2,392,15,193,118,75,54,51,14,1,13,0
03-04-2021,Mustangs,3,595,522,309,69,240,80,1,46,13,33,1
03-04-2021,CelestialInterface,2,166,46,16,2,14,98,83,15,7,8,1
03-04-2021,Discovery,1,339,192,12,4,8,78,54,24,21,3,2
03-04-2021,PrimeSeven,1,634,404,86,44,42,95,57,79,25,54,10
03-04-2021,Discovery,2,735,589,646,54,592,61,7,20,2,18,1
03-04-2021,BitterLaser,1,149,13,120,5,115,95,21,16,11,5,0
03-04-2021,Quicksilver,2,883,731,671,173,498,73,26,59,25,34,5
03-04-2021,CelestialInterface,3,391,43,65,57,8,72,55,25,2,23,1
03-04-2021,Mustangs,1,806,427,365,260,105,100,59,82,60,22,10
03-04-2021,Aurora,1,870,617,282,154,128,86,47,50,42,8,5
03-04-2021,BitterLaser,1,267,148,156,32,124,95,17,92,44,48,3
03-04-2021,ImpactTraining,3,469,25,379,22,357,90,38,84,64,20,10
03-04-2022,Mustangs,3,649,601,540,116,424,92,67,34,27,7,3
03-04-2022,BitterLaser,1,508,501,179,7,172,74,22,13,10,3,0
03-04-2022,Aurora,3,460,286,222,105,117,86,52,57,30,27,7
03-04-2022,Mustangs,2,777,598,241,96,145,76,48,15,6,9,1
03-04-2022,Honeycomb,2,807,693,581,539,42,80,52,24,0,24,1
03-04-2022,Quicksilver,1,450,361,356,169,187,57,25,40,23,17,4
03-04-2022,Mustangs,3,153,69,135,38,97,63,53,45,0,45,2
03-04-2022,ImpactTraining,3,164,63,79,78,1,84,15,11,9,2,0
03-04-2023,PrimeSeven,3,455,17,290,280,10,77,28,32,3,29,2
03-04-2023,Discovery,1,871,802,207,5,202,72,23,10,5,5,0
03-04-2023,Aurora,2,750,153,502,140,362,90,68,73,14,59,2
03-04-2023,BitterLaser,3,715,454,272,237,35,50,47,27,22,5,3
03-04-2023,CelestialInterface,2,800,155,478,229,249,70,37,5,2,3,0
03-04-2023,PrimeSeven,3,418,370,393,256,137,96,7,81,41,40,8
03-04-2023,Honeycomb,3,104,91,17,10,7,98,81,7,5,2,0
03-04-2023,Quicksilver,3,972,75,222,166,56,84,69,12,11,1,0
03-04-2023,CelestialInterface,3,289,43,196,8,188,92,84,54,23,31,4
03-04-2023,Aurora,2,483,466,191,12,179,92,75,47,32,15,6
03-05-2021,PrimeSeven,3,583,524,137,128,9,68,40,58,16,42,0
03-05-2021,ImpactTraining,1,491,458,38,14,24,60,1,14,0,14,1
03-05-2021,Discovery,1,652,521,52,23,29,64,32,19,1,18,1
03-05-2021,Discovery,3,441,25,399,375,24,58,11,56,38,18,4
03-05-2021,Quicksilver,2,302,220,119,91,28,54,11,5,0,5,0
03-05-2021,Discovery,2,159,149,148,29,119,94,68,88,58,30,11
03-05-2021,BitterLaser,1,376,352,364,247,117,76,17,33,12,21,2
03-05-2021,CelestialInterface,3,982,878,253,114,139,86,50,83,1,82,10
03-05-2021,CelestialInterface,1,874,748,525,224,301,99,59,24,1,23,0
03-05-2021,CelestialInterface,2,260,77,87,59,28,54,19,9,4,5,0
03-05-2021,BitterLaser,3,999,702,889,387,502,91,46,19,5,14,1
03-05-2022,ImpactTraining,1,845,146,47,14,33,97,74,39,22,17,1
03-05-2022,PrimeSeven,2,807,193,633,394,239,59,3,10,7,3,0
03-05-2022,Discovery,2,225,77,211,201,10,63,29,22,5,17,0
03-05-2022,BitterLaser,1,207,5,146,43,103,69,45,19,8,11,1
03-05-2022,GrayPanthers,3,627,620,332,323,9,61,20,8,5,3,0
03-05-2022,GrayPanthers,1,893,621,885,280,605,54,0,47,15,32,1
03-05-2022,PrimeSeven,2,149,35,60,3,57,89,85,41,34,7,2
03-05-2022,Honeycomb,2,409,258,285,280,5,69,18,59,0,59,1
03-05-2022,Honeycomb,2,933,676,681,2,679,100,18,23,10,13,0
03-05-2022,Honeycomb,1,129,3,124,28,96,87,33,8,2,6,0
03-05-2022,PrimeSeven,1,913,52,41,18,23,53,0,28,16,12,3
03-05-2023,Quicksilver,2,194,192,163,111,52,65,41,31,25,6,3
03-05-2023,Honeycomb,2,689,251,37,28,9,89,44,62,23,39,7
03-05-2023,CelestialInterface,1,408,93,7,2,5,96,42,84,28,56,9
03-05-2023,Aurora,1,836,698,459,378,81,55,43,6,2,4,0
03-05-2023,PrimeSeven,3,286,169,244,37,207,73,63,11,10,1,0
03-05-2023,BitterLaser,3,276,146,159,115,44,62,27,13,4,9,0
03-05-2023,Aurora,1,850,198,519,47,472,66,27,63,52,11,0
03-05-2023,Discovery,2,737,20,11,6,5,95,10,85,11,74,0
03-05-2023,Mustangs,1,978,256,214,25,189,79,59,3,2,1,0
03-05-2023,Discovery,3,536,444,218,103,115,63,49,15,14,1,0
03-05-2023,Aurora,3,227,173,176,146,30,66,12,35,15,20,1
03-05-2023,Honeycomb,3,938,614,62,45,17,65,6,12,4,8,0
03-06-2021,Quicksilver,3,200,137,12,6,6,98,56,78,60,18,1
03-06-2021,Discovery,2,803,513,409,25,384,56,14,7,6,1,0
03-06-2021,Aurora,3,653,153,485,224,261,54,24,31,19,12,1
03-06-2021,GrayPanthers,1,614,441,18,17,1,82,58,24,10,14,1
03-06-2021,Mustangs,3,881,430,393,149,244,93,58,83,28,55,0
03-06-2021,PrimeSeven,2,746,253,513,176,337,87,29,25,14,11,0
03-06-2021,Quicksilver,1,463,238,159,24,135,74,27,48,41,7,3
03-06-2021,PrimeSeven,3,811,632,579,92,487,87,38,74,67,7,9
03-06-2021,ImpactTraining,1,401,33,325,315,10,83,53,81,16,65,8
03-06-2021,Quicksilver,2,198,108,45,12,33,57,19,42,28,14,4
03-06-2022,Honeycomb,3,459,203,364,215,149,61,46,36,5,31,2
03-06-2022,Honeycomb,2,115,10,85,26,59,78,31,15,1,14,1
03-06-2022,PrimeSeven,2,792,89,369,284,85,55,3,31,6,25,3
03-06-2022,ImpactTraining,2,910,495,276,10,266,91,90,51,44,7,2
03-06-2022,Aurora,3,996,396,49,37,12,100,44,46,13,33,2
03-06-2022,ImpactTraining,3,524,181,167,22,145,78,4,9,3,6,0
03-06-2022,CelestialInterface,2,305,98,60,14,46,88,34,27,2,25,0
03-06-2022,Quicksilver,3,772,645,190,188,2,55,4,6,0,6,0
03-06-2022,PrimeSeven,1,702,590,20,2,18,93,18,90,54,36,3
03-06-2022,Quicksilver,2,521,452,136,122,14,82,76,48,32,16,1
03-06-2022,Quicksilver,3,318,64,252,171,81,98,91,16,11,5,0
03-06-2022,CelestialInterface,1,474,336,293,117,176,100,40,57,26,31,5
03-06-2022,Quicksilver,1,975,205,136,119,17,93,44,44,10,34,2
03-06-2023,Aurora,3,217,148,141,44,97,93,83,64,34,30,5
03-06-2023,Discovery,2,453,170,385,247,138,78,1,69,49,20,9
03-06-2023,Mustangs,1,147,109,86,35,51,68,21,30,10,20,2
03-06-2023,ImpactTraining,1,508,145,155,73,82,97,24,76,8,68,1
03-06-2023,PrimeSeven,2,347,306,303,294,9,60,13,50,10,40,2
03-06-2023,Honeycomb,1,617,365,476,103,373,82,14,53,39,14,1
03-06-2023,Honeycomb,3,437,125,179,122,57,80,66,72,0,72,5
03-06-2023,BitterLaser,3,506,233,116,104,12,84,10,18,13,5,0
03-06-2023,ImpactTraining,3,338,23,203,182,21,96,7,88,63,25,2
03-06-2023,PrimeSeven,2,616,18,381,237,144,50,35,42,12,30,0
03-07-2021,PrimeSeven,1,275,41,159,20,139,97,21,39,6,33,2
03-07-2021,BitterLaser,2,132,118,98,24,74,83,2,62,53,9,8
03-07-2021,Honeycomb,3,919,700,32,14,18,68,56,54,49,5,4
03-07-2021,Honeycomb,3,228,136,36,8,28,97,17,51,35,16,4
03-07-2021,Honeycomb,1,324,39,263,3,260,52,45,3,1,2,0
03-07-2021,Mustangs,1,984,827,624,87,537,80,22,59,12,47,3
03-07-2021,Mustangs,1,805,788,748,368,380,87,30,0,0,0,0
03-07-2021,Honeycomb,3,941,130,574,186,388,78,6,0,0,0,0
03-07-2022,Aurora,1,201,153,84,48,36,63,41,9,1,8,0
03-07-2022,Quicksilver,2,258,178,18,0,18,66,40,38,23,15,4
03-07-2022,Mustangs,2,639,0,33,14,19,93,10,37,21,16,4
03-07-2022,GrayPanthers,2,437,365,25,24,1,78,20,19,2,17,0
03-07-2022,Mustangs,2,174,52,30,7,23,71,65,13,5,8,0
03-07-2022,GrayPanthers,2,308,210,93,91,2,71,45,50,38,12,1
03-07-2022,Discovery,1,451,323,50,9,41,56,13,7,1,6,0
03-07-2022,PrimeSeven,3,828,700,705,336,369,84,70,53,30,23,3
03-07-2022,CelestialInterface,2,406,175,228,144,84,58,34,51,41,10,5
03-07-2022,BitterLaser,3,978,661,622,565,57,96,0,14,10,4,0
03-07-2023,ImpactTraining,1,385,203,296,200,96,69,34,6,0,6,0
03-07-2023,Honeycomb,1,758,389,539,389,150,94,33,7,3,4,0
03-07-2023,ImpactTraining,1,911,600,670,249,421,76,30,72,20,52,4
03-07-2023,PrimeSeven,2,151,129,149,83,66,90,18,32,13,19,3
03-07-2023,Discovery,1,201,109,128,79,49,65,57,7,4,3,0
03-07-2023,Honeycomb,2,956,498,237,84,153,60,48,35,22,13,4
03-08-2021,Aurora,3,646,447,16,7,9,97,89,56,36,20,0
03-08-2021,Quicksilver,3,934,298,91,66,25,89,68,41,40,1,1
03-08-2021,GrayPanthers,3,613,273,76,16,60,100,57,80,8,72,0
03-08-2021,Honeycomb,1,244,95,44,17,27,81,79,33,5,28,3
03-08-2021,CelestialInterface,2,536,254,424,368,56,72,3,49,32,17,2
03-08-2021,BitterLaser,1,712,478,2,1,1,57,11,51,43,8,4
03-08-2021,Mustangs,2,222,134,105,63,42,59,56,45,43,2,2
03-08-2021,CelestialInterface,1,581,468,475,241,234,58,24,51,22,29,0
03-08-2021,Quicksilver,3,501,336,440,291,149,73,1,11,5,6,0
03-08-2021,Aurora,3,426,49,197,82,115,72,62,0,0,0,0
03-08-2021,Aurora,3,869,597,611,484,127,60,41,40,14,26,0
03-08-2021,PrimeSeven,1,236,203,116,55,61,79,8,19,10,9,0
03-08-2022,Aurora,3,578,550,438,349,89,58,55,53,16,37,3
03-08-2022,ImpactTraining,2,938,356,249,233,16,74,32,9,2,7,0
03-08-2022,CelestialInterface,2,293,72,284,210,74,53,18,28,25,3,3
03-08-2022,BitterLaser,2,522,362,98,9,89,68,43,6,4,2,0
03-08-2022,BitterLaser,3,778,766,203,1,202,99,41,60,42,18,6
03-08-2022,PrimeSeven,1,321,211,132,54,78,85,15,28,20,8,1
03-08-2022,GrayPanthers,2,753,181,657,190,467,65,53,6,0,6,0
03-08-2022,Quicksilver,3,478,22,168,43,125,78,51,64,9,55,7
03-08-2022,CelestialInterface,1,443,102,80,10,70,96,36,43,7,36,0
03-08-2023,ImpactTraining,1,935,187,13,6,7,79,37,66,24,42,7
03-08-2023,BitterLaser,2,593,326,22,0,22,97,57,56,28,28,3
03-08-2023,GrayPanthers,1,303,21,182,127,55,99,70,94,17,77,3
03-08-2023,BitterLaser,3,518,351,462,334,128,87,66,83,71,12,11
03-08-2023,CelestialInterface,1,615,280,319,81,238,55,44,42,23,19,0
03-08-2023,BitterLaser,2,953,603,112,24,88,86,42,82,21,61,7
03-08-2023,CelestialInterface,3,171,152,36,9,27,90,18,16,10,6,0
03-08-2023,PrimeSeven,1,541,502,231,58,173,66,17,37,8,29,1
03-08-2023,ImpactTraining,2,722,574,609,18,591,95,83,41,40,1,4
03-08-2023,CelestialInterface,3,243,92,65,15,50,96,58,8,6,2,0
03-08-2023,Mustangs,1,742,722,688,287,401,68,59,39,8,31,1
03-08-2023,Mustangs,1,731,589,133,40,93,80,31,77,13,64,0
03-09-2021,Discovery,2,726,354,545,104,441,62,57,55,25,30,0
03-09-2021,ImpactTraining,2,353,111,340,197,143,55,15,30,8,22,3
03-09-2021,CelestialInterface,3,397,154,329,249,80,95,10,76,47,29,8
03-09-2021,Mustangs,1,355,207,28,10,18,76,60,35,24,11,0
03-09-2021,CelestialInterface,2,478,38,63,37,26,69,29,2,1,1,0
03-09-2021,GrayPanthers,2,577,101,26,22,4,98,58,63,6,57,7
03-09-2021,CelestialInterface,2,335,31,121,59,62,75,30,0,0,0,0
03-09-2021,Quicksilver,1,426,276,231,58,173,88,78,4,0,4,0
03-09-2021,ImpactTraining,1,518,53,169,31,138,85,64,77,51,26,6
03-09-2021,PrimeSeven,3,678,335,149,51,98,95,76,2,1,1,0
03-09-2022,Mustangs,2,501,439,113,111,2,69,29,17,12,5,1
03-09-2022,BitterLaser,1,542,92,523,254,269,82,21,14,7,7,1
03-09-2022,BitterLaser,1,196,175,151,149,2,97,63,67,27,40,1
03-09-2022,Aurora,3,642,209,629,1,628,99,43,18,9,9,0
03-09-2022,Aurora,1,913,404,454,67,387,53,2,43,40,3,1
03-09-2022,GrayPanthers,2,446,372,82,69,13,88,7,77,51,26,0
03-09-2022,CelestialInterface,2,882,131,61,43,18,85,4,0,0,0,0
03-09-2022,Aurora,3,229,66,60,23,37,69,1,61,4,57,8
03-09-2022,BitterLaser,3,735,247,255,155,100,80,69,42,4,38,5
03-09-2022,Mustangs,1,596,244,99,68,31,77,68,5,0,5,0
03-09-2022,ImpactTraining,2,116,46,96,30,66,64,47,4,2,2,0
03-09-2022,Honeycomb,2,132,103,123,54,69,54,17,41,3,38,0
03-09-2022,BitterLaser,3,371,349,362,334,28,86,35,43,29,14,4
03-09-2022,Honeycomb,3,738,724,307,184,123,73,12,18,17,1,1
03-09-2023,Quicksilver,2,839,37,282,194,88,87,46,56,31,25,6
03-09-2023,Quicksilver,1,898,271,354,299,55,61,28,9,7,2,0
03-09-2023,PrimeSeven,1,377,79,317,316,1,97,9,96,30,66,1
03-09-2023,Quicksilver,1,857,758,806,616,190,74,59,24,3,21,1
03-09-2023,CelestialInterface,1,219,94,202,80,122,55,10,36,5,31,2
03-09-2023,CelestialInterface,1,985,744,586,84,502,87,5,38,29,9,1
03-09-2023,Honeycomb,3,442,28,307,24,283,74,71,63,23,40,0
03-09-2023,GrayPanthers,1,132,52,67,55,12,100,10,89,13,76,6
03-09-2023,CelestialInterface,1,497,32,350,295,55,74,21,9,1,8,0
03-09-2023,BitterLaser,3,400,321,25,19,6,58,30,31,12,19,2
03-09-2023,Honeycomb,2,186,16,134,126,8,73,13,9,3,6,0
03-09-2023,BitterLaser,2,708,614,624,293,331,73,9,58,57,1,3
03-10-2021,Mustangs,3,464,296,86,64,22,88,84,10,9,1,0
03-10-2021,Quicksilver,2,132,10,20,10,10,55,39,47,21,26,2
03-10-2021,Mustangs,2,657,184,19,3,16,77,40,47,42,5,2
03-10-2021,Aurora,2,234,94,209,180,29,91,41,81,63,18,0
03-10-2021,BitterLaser,2,591,289,122,86,36,74,5,34,26,8,1
03-10-2021,Aurora,1,728,592,725,67,658,85,11,33,4,29,1
03-10-2021,ImpactTraining,3,835,679,623,150,473,96,28,92,7,85,12
03-10-2021,Mustangs,2,767,524,721,337,384,81,25,61,40,21,0
03-10-2021,BitterLaser,3,909,805,867,763,104,92,87,67,13,54,2
03-10-2021,GrayPanthers,3,194,82,92,89,3,99,47,66,18,48,4
03-10-2021,Honeycomb,2,626,38,310,31,279,55,34,48,5,43,1
03-10-2021,Honeycomb,2,358,141,133,36,97,90,28,84,41,43,3
03-10-2021,Quicksilver,3,968,722,505,172,333,87,23,52,23,29,4
03-10-2022,Quicksilver,2,710,97,281,265,16,72,54,60,10,50,1
03-10-2022,PrimeSeven,3,175,92,152,108,44,73,27,69,56,13,2
03-10-2022,Aurora,3,906,616,806,550,256,79,52,26,7,19,0
03-10-2022,Honeycomb,2,147,106,10,7,3,51,43,10,2,8,0
03-10-2022,Honeycomb,2,813,89,157,68,89,87,14,61,57,4,4
03-10-2022,Honeycomb,2,698,690,436,233,203,76,62,38,37,1,4
03-10-2022,Mustangs,3,400,159,291,203,88,86,8,27,24,3,1
03-10-2023,GrayPanthers,2,751,688,119,111,8,77,46,25,0,25,2
03-10-2023,Aurora,1,624,173,301,31,270,62,58,18,16,2,1
03-10-2023,CelestialInterface,2,489,393,234,35,199,71,68,23,10,13,1
03-10-2023,ImpactTraining,1,880,35,113,3,110,86,40,76,30,46,2
03-10-2023,Aurora,3,950,229,171,100,71,66,33,44,40,4,3
03-10-2023,GrayPanthers,3,208,56,7,0,7,76,63,27,21,6,3
03-10-2023,CelestialInterface,3,695,457,481,310,171,60,0,16,5,11,1
03-10-2023,BitterLaser,2,181,71,15,9,6,73,16,19,15,4,0
03-10-2023,Discovery,3,437,368,400,307,93,53,26,43,20,23,1
03-11-2021,Discovery,1,588,517,180,148,32,64,27,39,14,25,4
03-11-2021,Mustangs,2,908,96,790,45,745,55,3,27,3,24,2
03-11-2021,ImpactTraining,2,865,640,792,303,489,85,21,41,8,33,3
03-11-2021,BitterLaser,1,467,125,5,2,3,91,33,22,16,6,2
03-11-2021,BitterLaser,2,309,26,146,105,41,86,51,69,50,19,6
03-11-2021,CelestialInterface,3,765,456,527,286,241,87,2,86,43,43,6
03-11-2021,CelestialInterface,2,346,192,62,56,6,98,34,67,39,28,0
03-11-2021,Discovery,3,744,20,109,32,77,56,13,10,0,10,0
03-11-2021,Quicksilver,2,805,769,184,43,141,98,41,79,39,40,4
03-11-2021,Honeycomb,3,571,401,264,129,135,87,19,78,7,71,5
03-11-2022,Honeycomb,2,958,754,201,124,77,75,35,4,1,3,0
03-11-2022,PrimeSeven,1,327,127,92,43,49,84,34,70,4,66,4
03-11-2022,Honeycomb,3,375,193,198,12,186,77,29,12,7,5,0
03-11-2022,PrimeSeven,1,452,4,271,34,237,52,21,27,13,14,0
03-11-2022,BitterLaser,1,673,632,613,168,445,98,67,31,22,9,1
03-11-2022,Mustangs,2,148,35,119,116,3,81,23,75,9,66,4
03-11-2022,BitterLaser,1,917,247,541,62,479,50,37,2,1,1,0
03-11-2022,Quicksilver,2,715,477,527,500,27,84,82,8,4,4,0
03-11-2022,Honeycomb,2,474,261,210,28,182,69,42,9,2,7,0
03-11-2022,Discovery,3,512,228,373,246,127,97,56,36,7,29,3
03-11-2022,CelestialInterface,1,314,215,23,4,19,66,15,61,8,53,1
03-11-2022,ImpactTraining,1,155,118,35,4,31,83,77,79,21,58,7
03-11-2022,GrayPanthers,1,477,287,231,0,231,70,3,2,0,2,0
03-11-2022,Discovery,3,311,63,177,83,94,54,15,32,14,18,1
03-11-2023,ImpactTraining,1,952,529,805,215,590,66,33,64,35,29,5
03-11-2023,PrimeSeven,1,199,151,77,14,63,54,37,8,0,8,0
03-11-2023,Honeycomb,2,207,126,81,39,42,91,58,83,8,75,2
03-11-2023,ImpactTraining,1,727,358,473,229,244,75,16,30,12,18,3
03-11-2023,Quicksilver,3,542,249,466,439,27,72,28,21,6,15,1
03-11-2023,Quicksilver,1,507,347,10,5,5,67,15,60,7,53,6
03-11-2023,Honeycomb,1,497,335,184,32,152,91,49,31,11,20,0
03-11-2023,PrimeSeven,2,592,375,572,202,370,87,29,73,29,44,9
03-11-2023,Quicksilver,3,795,728,700,96,604,79,68,47,13,34,2
03-12-2021,ImpactTraining,2,266,230,49,25,24,71,56,6,1,5,0
03-12-2021,BitterLaser,1,183,84,87,63,24,56,34,30,29,1,0
03-12-2021,Discovery,2,186,182,181,62,119,72,19,14,7,7,0
03-12-2021,Aurora,2,473,55,59,3,56,88,86,57,13,44,0
03-12-2021,Quicksilver,3,522,16,330,117,213,73,15,3,0,3,0
03-12-2021,ImpactTraining,2,894,876,670,5,665,94,84,44,28,16,2
03-12-2021,Discovery,3,738,233,680,259,421,77,65,23,18,5,1
03-12-2021,Honeycomb,2,959,921,776,239,537,87,5,27,8,19,2
03-12-2021,Discovery,2,196,149,121,110,11,63,58,20,18,2,2
03-12-2022,CelestialInterface,2,331,52,320,287,33,64,54,53,50,3,3
03-12-2022,GrayPanthers,2,166,56,163,23,140,96,8,62,15,47,7
03-12-2022,Honeycomb,3,619,290,354,8,346,57,56,34,13,21,1
03-12-2022,Honeycomb,3,115,63,88,75,13,94,31,12,6,6,0
03-12-2022,Aurora,1,359,185,41,24,17,76,56,44,23,21,4
03-12-2022,BitterLaser,3,204,65,57,17,40,94,61,40,39,1,2
03-12-2022,PrimeSeven,3,339,111,209,199,10,96,28,38,13,25,2
03-12-2022,Discovery,3,396,26,159,98,61,53,5,29,10,19,0
03-12-2023,Aurora,1,569,156,285,140,145,78,64,8,0,8,0
03-12-2023,ImpactTraining,1,206,160,59,55,4,87,79,47,11,36,3
03-12-2023,GrayPanthers,2,598,420,205,166,39,78,43,66,55,11,8
03-12-2023,Mustangs,2,592,430,403,84,319,80,4,37,13,24,0
03-12-2023,Aurora,3,256,103,41,11,30,91,2,63,59,4,1
03-12-2023,Aurora,1,973,55,177,27,150,50,26,28,19,9,0
03-12-2023,Discovery,3,374,196,121,83,38,90,22,16,8,8,0
03-12-2023,PrimeSeven,3,545,542,191,182,9,50,13,3,1,2,0
03-12-2023,ImpactTraining,1,674,354,43,12,31,61,60,41,33,8,2
03-12-2023,GrayPanthers,2,615,81,349,170,179,77,31,51,35,16,4
03-12-2023,GrayPanthers,1,916,908,779,509,270,92,5,77,34,43,1
04-01-2021,Aurora,1,381,253,45,4,41,62,39,24,15,9,0
04-01-2021,Quicksilver,2,284,150,222,69,153,86,72,49,41,8,3
04-01-2021,Discovery,2,496,137,331,0,331,79,56,49,35,14,4
04-01-2021,Quicksilver,3,287,272,91,32,59,96,68,82,2,80,3
04-01-2021,Discovery,3,560,57,373,48,325,79,9,7,2,5,0
04-01-2021,Aurora,2,203,101,37,2,35,67,34,10,0,10,0
04-01-2021,Aurora,1,353,86,139,6,133,55,11,9,5,4,0
04-01-2021,PrimeSeven,2,693,434,284,140,144,91,55,11,7,4,0
04-01-2021,CelestialInterface,3,583,204,307,224,83,51,34,21,13,8,2
04-01-2021,ImpactTraining,1,405,173,284,20,264,88,24,60,44,16,1
04-01-2021,Honeycomb,2,976,852,761,211,550,59,2,1,0,1,0
04-01-2021,CelestialInterface,2,825,265,7,3,4,79,60,11,4,7,0
04-01-2021,Discovery,2,998,526,935,6,929,95,85,63,32,31,6
04-01-2022,Honeycomb,2,256,156,231,50,181,54,2,21,20,1,0
04-01-2022,ImpactTraining,3,589,232,487,127,360,84,48,38,6,32,3
04-01-2022,ImpactTraining,3,733,217,452,78,374,55,42,24,17,7,1
04-01-2022,ImpactTraining,1,309,27,277,21,256,69,44,59,18,41,0
04-01-2022,CelestialInterface,2,212,136,179,146,33,76,57,18,5,13,0
04-01-2022,Discovery,2,848,222,254,26,228,75,57,43,38,5,0
04-01-2022,Discovery,3,119,27,69,13,56,98,76,8,0,8,0
04-01-2022,ImpactTraining,1,313,23,273,225,48,79,65,53,52,1,3
04-01-2022,Quicksilver,1,169,99,75,42,33,90,3,1,0,1,0
04-01-2022,Mustangs,1,246,106,140,107,33,54,12,10,7,3,0
04-01-2022,Quicksilver,2,410,114,207,108,99,66,45,20,19,1,0
04-01-2022,GrayPanthers,3,152,39,90,56,34,78,13,56,50,6,2
04-01-2022,CelestialInterface,2,835,795,785,347,438,73,7,36,8,28,0
04-01-2022,GrayPanthers,2,774,70,27,3,24,54,2,8,1,7,0
04-01-2023,BitterLaser,2,143,42,89,11,78,50,32,44,4,40,2
04-01-2023,GrayPanthers,1,718,387,687,370,317,51,28,21,12,9,2
04-01-2023,Honeycomb,3,434,239,69,63,6,98,31,86,54,32,8
04-01-2023,Quicksilver,3,172,10,114,57,57,74,68,40,5,35,1
04-01-2023,Aurora,3,195,150,171,147,24,55,43,22,8,14,1
04-01-2023,PrimeSeven,3,534,453,417,412,5,75,49,42,15,27,5
04-01-2023,GrayPanthers,3,683,662,274,246,28,51,30,35,34,1,1
04-01-2023,Aurora,2,974,776,771,752,19,66,11,23,12,11,2
04-01-2023,PrimeSeven,1,866,452,44,3,41,82,80,65,21,44,6
04-01-2023,CelestialInterface,1,585,42,156,21,135,57,24,30,3,27,2
04-02-2021,Aurora,2,673,4,39,14,25,77,57,54,36,18,4
04-02-2021,Aurora,2,794,176,463,109,354,100,46,60,43,17,7
04-02-2021,Honeycomb,1,265,165,72,46,26,70,49,34,24,10,4
04-02-2021,Honeycomb,3,382,276,186,127,59,82,51,38,19,19,3
04-02-2021,GrayPanthers,3,195,155,72,59,13,60,22,0,0,0,0
04-02-2022,Mustangs,3,581,233,288,84,204,64,49,16,11,5,0
04-02-2022,ImpactTraining,1,187,73,76,23,53,82,18,49,27,22,4
04-02-2022,BitterLaser,3,531,458,34,4,30,51,48,1,0,1,0
04-02-2022,Discovery,1,106,10,87,47,40,59,17,22,9,13,2
04-02-2023,Quicksilver,3,538,272,406,191,215,63,7,49,37,12,4
04-02-2023,Quicksilver,1,745,605,41,11,30,81,51,60,22,38,3
04-02-2023,PrimeSeven,3,496,347,159,141,18,59,55,34,1,33,2
04-02-2023,ImpactTraining,2,171,71,140,5,135,54,22,51,43,8,2
04-02-2023,Discovery,3,934,843,354,176,178,84,17,20,3,17,2
04-02-2023,BitterLaser,3,433,160,81,30,51,53,27,27,9,18,3
04-02-2023,CelestialInterface,1,314,142,124,79,45,77,73,0,0,0,0
04-02-2023,Quicksilver,1,904,886,700,646,54,65,54,43,39,4,3
04-02-2023,PrimeSeven,3,798,262,160,2,158,99,46,93,82,11,12
04-02-2023,Quicksilver,3,242,235,189,132,57,92,14,59,7,52,6
04-02-2023,Discovery,2,674,653,588,461,127,95,63,67,58,9,0
04-02-2023,Quicksilver,1,594,530,53,52,1,89,61,70,1,69,4
04-02-2023,Mustangs,1,332,47,258,2,256,78,21,67,28,39,4
04-02-2023,Quicksilver,2,275,183,124,37,87,89,41,31,11,20,3
04-02-2023,Aurora,2,568,286,197,12,185,64,35,44,43,1,2
04-02-2023,PrimeSeven,1,137,132,17,0,17,59,22,57,40,17,3
04-02-2023,ImpactTraining,2,151,86,103,38,65,51,4,49,7,42,4
04-03-2021,CelestialInterface,3,905,789,698,159,539,70,68,39,19,20,2
04-03-2021,Aurora,1,611,167,187,71,116,61,23,28,7,21,2
04-03-2021,CelestialInterface,2,234,149,57,52,5,95,0,54,5,49,5
04-03-2021,PrimeSeven,3,818,198,433,20,413,88,37,53,0,53,1
04-03-2021,Quicksilver,3,527,160,520,352,168,78,1,60,59,1,1
04-03-2021,BitterLaser,2,523,96,463,461,2,98,95,52,2,50,4
04-03-2021,Mustangs,3,945,920,298,179,119,95,47,88,80,8,0
04-03-2022,PrimeSeven,1,457,435,296,209,87,88,84,81,30,51,10
04-03-2022,Aurora,1,331,196,18,11,7,89,12,24,1,23,2
04-03-2022,PrimeSeven,2,532,195,226,115,111,59,25,8,6,2,0
04-03-2023,Mustangs,3,699,442,208,35,173,54,0,40,30,10,5
04-03-2023,Quicksilver,2,488,427,199,84,115,71,62,38,36,2,4
04-03-2023,Discovery,1,312,123,287,62,225,93,25,34,29,5,1
04-03-2023,PrimeSeven,3,443,329,268,7,261,60,2,30,9,21,3
04-03-2023,Aurora,3,939,909,104,26,78,53,50,3,1,2,0
04-03-2023,CelestialInterface,3,307,55,306,139,167,58,20,24,1,23,1
04-03-2023,Honeycomb,2,151,104,96,62,34,77,32,33,25,8,3
04-03-2023,ImpactTraining,2,482,154,204,43,161,70,9,10,6,4,0
04-03-2023,Discovery,1,836,505,381,344,37,97,32,73,18,55,1
04-03-2023,GrayPanthers,2,848,193,55,16,39,89,0,28,1,27,3
04-03-2023,PrimeSeven,1,662,380,34,4,30,64,12,12,10,2,0
04-04-2021,BitterLaser,1,742,598,613,357,256,79,44,52,12,40,5
04-04-2021,Aurora,3,339,186,5,3,2,75,46,63,34,29,5
04-04-2021,Quicksilver,2,108,81,84,48,36,99,92,80,56,24,10
04-04-2021,Quicksilver,3,831,614,349,49,300,85,63,74,41,33,0
04-04-2021,ImpactTraining,1,213,146,106,15,91,98,37,14,3,11,1
04-04-2021,Discovery,1,857,26,209,188,21,71,53,37,11,26,1
04-04-2021,Aurora,3,735,612,133,25,108,95,13,93,23,70,12
04-04-2021,Mustangs,2,518,192,334,31,303,75,13,44,31,13,2
04-04-2022,ImpactTraining,2,463,127,394,170,224,73,70,16,9,7,1
04-04-2022,GrayPanthers,1,473,421,50,10,40,52,45,6,1,5,0
04-04-2022,Honeycomb,3,816,565,127,111,16,79,61,6,3,3,0
04-04-2022,Mustangs,2,216,22,150,11,139,59,14,19,11,8,1
04-04-2022,PrimeSeven,3,978,206,332,88,244,75,26,23,5,18,1
04-04-2023,Quicksilver,2,829,116,625,118,507,78,3,71,44,27,4
04-04-2023,CelestialInterface,2,178,167,89,30,59,80,38,72,49,23,6
04-04-2023,CelestialInterface,3,705,239,501,241,260,93,91,60,35,25,2
04-04-2023,Aurora,2,637,607,178,162,16,100,89,33,26,7,1
04-04-2023,BitterLaser,2,204,39,64,62,2,53,3,45,23,22,2
04-04-2023,PrimeSeven,3,789,298,407,93,314,92,41,34,25,9,0
04-04-2023,CelestialInterface,1,765,477,700,366,334,56,34,40,27,13,1
04-04-2023,GrayPanthers,1,158,29,98,22,76,68,11,49,48,1,1
04-04-2023,Quicksilver,3,330,211,83,55,28,52,40,50,19,31,5
04-04-2023,Honeycomb,1,970,947,598,12,586,69,38,14,6,8,0
04-05-2021,Quicksilver,3,794,606,527,0,527,90,87,52,23,29,1
04-05-2021,Honeycomb,2,857,248,460,198,262,90,7,28,19,9,1
04-05-2021,Discovery,3,848,486,174,78,96,64,12,36,0,36,2
04-05-2021,CelestialInterface,2,780,131,695,396,299,79,53,50,6,44,2
04-05-2021,Aurora,1,258,68,19,14,5,54,45,45,31,14,0
04-05-2021,Honeycomb,3,469,312,423,215,208,77,38,38,28,10,3
04-05-2021,ImpactTraining,1,836,97,647,390,257,54,42,2,0,2,0
04-05-2021,GrayPanthers,1,655,129,209,157,52,65,27,29,12,17,2
04-05-2022,ImpactTraining,2,398,337,320,189,131,66,36,26,19,7,2
04-05-2022,Discovery,1,667,45,348,112,236,59,43,41,27,14,3
04-05-2022,PrimeSeven,2,308,202,203,32,171,62,40,1,0,1,0
04-05-2022,CelestialInterface,1,486,112,175,103,72,87,19,30,23,7,2
04-05-2022,Discovery,3,905,87,660,432,228,76,23,50,23,27,5
04-05-2022,PrimeSeven,1,342,243,292,21,271,70,16,0,0,0,0
04-05-2022,ImpactTraining,2,258,71,30,17,13,85,42,3,0,3,0
04-05-2023,BitterLaser,2,364,316,173,73,100,97,51,52,25,27,6
04-05-2023,PrimeSeven,2,184,114,67,1,66,75,4,27,13,14,3
04-05-2023,Discovery,1,108,107,85,12,73,83,63,49,37,12,5
04-05-2023,Quicksilver,1,832,44,423,146,277,54,35,15,3,12,0
04-05-2023,Discovery,3,740,645,624,345,279,67,3,23,8,15,0
04-05-2023,PrimeSeven,2,165,4,64,62,2,99,83,12,0,12,0
04-05-2023,GrayPanthers,2,912,139,227,122,105,59,5,30,14,16,3
04-05-2023,Discovery,2,930,867,97,93,4,50,11,36,23,13,3
04-05-2023,ImpactTraining,2,848,668,397,98,299,86,59,32,13,19,0
04-05-2023,CelestialInterface,3,961,953,591,535,56,74,35,2,1,1,0
04-06-2021,Aurora,3,169,6,119,102,17,88,77,34,13,21,2
04-06-2021,CelestialInterface,1,492,20,114,68,46,68,20,1,0,1,0
04-06-2021,Discovery,2,502,370,236,205,31,65,44,19,1,18,1
04-06-2021,BitterLaser,3,205,15,131,108,23,50,26,13,9,4,0
04-06-2021,CelestialInterface,3,448,446,132,97,35,77,44,47,2,45,5
04-06-2021,ImpactTraining,2,882,509,349,218,131,84,52,82,31,51,0
04-06-2021,ImpactTraining,3,537,513,201,197,4,69,29,16,11,5,1
04-06-2021,PrimeSeven,3,116,29,57,39,18,99,48,87,4,83,0
04-06-2021,Mustangs,3,747,411,476,111,365,91,1,20,9,11,2
04-06-2021,CelestialInterface,3,430,410,384,204,180,57,47,48,4,44,3
04-06-2022,CelestialInterface,1,373,202,196,46,150,98,80,32,15,17,0
04-06-2022,Discovery,2,911,2,472,273,199,84,36,51,36,15,5
04-06-2022,ImpactTraining,1,379,123,188,16,172,75,61,60,15,45,8
04-06-2022,BitterLaser,1,577,406,88,78,10,92,86,14,0,14,1
04-06-2022,CelestialInterface,1,690,254,325,176,149,82,66,41,28,13,2
04-06-2022,PrimeSeven,1,567,55,38,27,11,70,47,47,40,7,1
04-06-2022,ImpactTraining,2,244,87,64,41,23,54,15,24,9,15,2
04-06-2022,PrimeSeven,1,173,162,129,16,113,98,70,16,0,16,1
04-06-2022,CelestialInterface,1,915,786,772,349,423,86,44,57,22,35,3
04-06-2023,BitterLaser,1,896,550,882,735,147,78,75,52,1,51,1
04-06-2023,ImpactTraining,2,840,539,63,2,61,55,42,35,0,35,1
04-06-2023,Aurora,2,800,176,511,351,160,57,37,0,0,0,0
04-06-2023,CelestialInterface,2,411,124,162,132,30,88,71,18,1,17,0
04-06-2023,CelestialInterface,1,751,94,173,148,25,62,15,35,23,12,0
04-06-2023,PrimeSeven,2,567,398,283,44,239,91,79,15,2,13,1
04-06-2023,Quicksilver,3,156,92,46,7,39,58,47,53,48,5,1
04-06-2023,Aurora,3,745,619,221,215,6,82,13,21,18,3,1
04-06-2023,PrimeSeven,2,371,122,301,152,149,60,33,8,7,1,0
04-06-2023,PrimeSeven,3,552,10,507,39,468,55,40,22,19,3,1
04-06-2023,Quicksilver,3,956,257,428,175,253,75,49,16,6,10,0
04-07-2021,GrayPanthers,1,109,59,60,6,54,52,20,33,24,9,1
04-07-2021,Aurora,1,592,136,27,18,9,89,20,75,52,23,10
04-07-2021,Quicksilver,2,646,286,84,46,38,50,6,45,4,41,0
04-07-2021,Mustangs,3,333,81,174,106,68,59,13,55,40,15,5
04-07-2021,BitterLaser,1,511,227,326,215,111,77,58,3,0,3,0
04-07-2021,CelestialInterface,3,160,92,120,47,73,51,11,25,16,9,0
04-07-2021,Quicksilver,3,227,33,128,58,70,79,64,72,49,23,0
04-07-2021,Quicksilver,2,626,438,402,374,28,79,75,16,14,2,1
04-07-2021,BitterLaser,3,795,260,112,86,26,76,58,26,12,14,0
04-07-2021,GrayPanthers,1,105,89,61,51,10,97,24,44,22,22,2
04-07-2022,GrayPanthers,2,805,5,50,6,44,79,0,51,14,37,4
04-07-2022,Quicksilver,3,785,431,697,193,504,69,68,51,21,30,5
04-07-2022,PrimeSeven,1,914,753,473,226,247,99,41,4,0,4,0
04-07-2022,ImpactTraining,3,204,155,125,3,122,65,40,32,2,30,2
04-07-2022,Honeycomb,2,233,211,125,115,10,62,32,42,2,40,5
04-07-2022,Aurora,2,439,234,321,101,220,70,61,25,20,5,2
04-07-2022,BitterLaser,1,754,126,495,349,146,65,12,1,0,1,0
04-07-2022,GrayPanthers,2,652,387,25,11,14,87,15,12,9,3,0
04-07-2022,Discovery,2,575,301,291,46,245,93,34,63,33,30,6
04-07-2022,ImpactTraining,1,790,92,704,547,157,75,47,30,11,19,1
04-07-2022,PrimeSeven,2,886,590,94,84,10,76,52,63,23,40,7
04-07-2023,PrimeSeven,3,525,405,366,363,3,94,76,92,32,60,5
04-07-2023,PrimeSeven,1,437,151,83,35,48,59,6,7,0,7,0
04-07-2023,Discovery,2,410,297,89,51,38,100,43,69,17,52,1
04-07-2023,Quicksilver,2,635,595,311,238,73,59,38,27,7,20,3
04-07-2023,GrayPanthers,2,861,353,659,172,487,50,38,15,11,4,1
04-08-2021,ImpactTraining,1,494,414,165,142,23,69,21,23,4,19,1
04-08-2021,Aurora,1,988,46,229,130,99,71,49,68,31,37,4
04-08-2021,GrayPanthers,3,398,351,290,57,233,51,15,49,14,35,5
04-08-2021,GrayPanthers,1,749,648,4,3,1,88,9,59,25,34,6
04-08-2021,Quicksilver,1,742,518,116,37,79,58,28,45,18,27,2
04-08-2021,Aurora,2,708,334,288,51,237,62,36,38,14,24,0
04-08-2021,Quicksilver,3,427,43,221,198,23,58,30,55,3,52,6
04-08-2021,BitterLaser,3,248,35,233,146,87,60,10,13,0,13,0
04-08-2021,ImpactTraining,1,547,462,440,78,362,80,72,12,1,11,0
04-08-2021,Aurora,3,940,535,681,673,8,94,51,20,9,11,1
04-08-2022,CelestialInterface,1,521,33,94,32,62,71,4,69,7,62,1
04-08-2022,GrayPanthers,1,342,201,92,34,58,96,28,61,30,31,2
04-08-2022,Honeycomb,1,402,175,327,170,157,90,19,79,41,38,6
04-08-2022,Mustangs,2,620,38,272,122,150,91,16,77,10,67,3
04-08-2022,Honeycomb,3,323,219,215,88,127,86,30,29,11,18,1
04-08-2022,PrimeSeven,3,557,164,406,362,44,77,45,24,8,16,1
04-08-2022,PrimeSeven,2,693,664,245,158,87,60,26,2,1,1,0
04-08-2022,PrimeSeven,1,400,321,68,11,57,84,80,23,16,7,1
04-08-2022,Aurora,2,669,472,518,46,472,92,38,50,37,13,3
04-08-2022,Quicksilver,2,300,136,78,39,39,51,10,37,4,33,3
04-08-2022,GrayPanthers,1,858,198,807,724,83,63,33,22,6,16,2
04-08-2022,BitterLaser,2,945,64,649,158,491,75,18,38,34,4,1
04-08-2023,Mustangs,3,612,516,495,378,117,75,12,61,31,30,6
04-08-2023,ImpactTraining,1,801,728,731,202,529,91,69,73,71,2,5
04-08-2023,Honeycomb,3,236,180,34,0,34,56,43,18,15,3,1
04-08-2023,Aurora,2,727,539,565,538,27,79,63,44,5,39,3
04-08-2023,PrimeSeven,3,130,113,47,21,26,65,8,56,35,21,4
04-08-2023,Discovery,2,650,103,174,52,122,53,1,52,15,37,2
04-08-2023,PrimeSeven,1,220,10,212,39,173,63,26,0,0,0,0
04-08-2023,CelestialInterface,1,160,66,104,71,33,99,39,38,2,36,1
04-08-2023,GrayPanthers,3,237,4,180,31,149,86,24,44,0,44,2
04-09-2021,Quicksilver,3,775,191,586,555,31,82,27,14,11,3,1
04-09-2021,BitterLaser,2,270,187,59,48,11,62,26,48,46,2,6
04-09-2021,ImpactTraining,3,484,236,213,54,159,75,73,6,1,5,0
04-09-2021,Aurora,3,508,18,455,400,55,87,20,79,30,49,4
04-09-2021,Honeycomb,1,329,74,260,76,184,64,15,9,0,9,0
04-09-2021,Discovery,2,640,605,448,267,181,95,78,54,1,53,7
04-09-2021,PrimeSeven,3,614,473,550,164,386,62,46,32,30,2,2
04-09-2021,PrimeSeven,2,765,62,191,16,175,94,38,47,9,38,6
04-09-2021,GrayPanthers,3,145,135,79,53,26,93,80,78,24,54,5
04-09-2021,Discovery,1,519,56,392,126,266,70,19,68,8,60,3
04-09-2022,Honeycomb,2,671,311,455,175,280,56,34,36,1,35,4
04-09-2022,Aurora,3,136,10,76,35,41,64,24,22,13,9,2
04-09-2022,ImpactTraining,2,679,279,653,589,64,61,11,16,3,13,0
04-09-2022,BitterLaser,1,692,387,672,296,376,94,17,20,6,14,2
04-09-2022,ImpactTraining,3,283,100,77,73,4,59,40,42,20,22,3
04-09-2022,ImpactTraining,3,653,189,6,3,3,83,29,67,11,56,3
04-09-2022,Mustangs,1,223,88,21,2,19,96,35,94,74,20,8
04-09-2022,BitterLaser,3,984,975,768,192,576,75,29,57,10,47,1
04-09-2022,Aurora,1,261,165,203,65,138,100,78,27,23,4,3
04-09-2022,Honeycomb,3,438,42,218,66,152,51,14,50,3,47,4
04-09-2022,Honeycomb,2,797,718,763,394,369,51,21,41,39,2,4
04-09-2023,Mustangs,2,618,505,592,412,180,53,22,39,21,18,2
04-09-2023,Honeycomb,3,845,648,289,176,113,64,1,24,22,2,1
04-09-2023,PrimeSeven,1,946,664,448,100,348,81,71,15,8,7,1
04-09-2023,ImpactTraining,1,872,711,794,283,511,59,45,3,1,2,0
04-09-2023,ImpactTraining,3,704,160,637,615,22,98,32,78,30,48,1
04-09-2023,CelestialInterface,1,295,173,104,85,19,73,27,23,19,4,2
04-09-2023,CelestialInterface,2,506,1,190,188,2,68,21,52,41,11,2
04-10-2021,Discovery,3,731,661,625,110,515,99,57,67,8,59,0
04-10-2021,CelestialInterface,3,195,85,134,43,91,84,21,3,1,2,0
04-10-2021,BitterLaser,2,521,213,501,298,203,51,1,50,40,10,4
04-10-2021,Honeycomb,2,777,702,256,33,223,54,26,36,33,3,4
04-10-2021,CelestialInterface,2,791,317,774,48,726,95,7,87,14,73,2
04-10-2021,CelestialInterface,3,545,267,44,5,39,100,47,12,4,8,0
04-10-2021,Quicksilver,1,464,43,266,177,89,82,22,28,11,17,2
04-10-2021,Aurora,3,199,69,166,58,108,64,8,42,12,30,3
04-10-2022,BitterLaser,2,659,658,155,31,124,92,9,57,12,45,5
04-10-2022,BitterLaser,2,258,83,67,30,37,97,69,23,15,8,2
04-10-2022,Discovery,1,247,67,121,23,98,59,7,50,49,1,6
04-10-2022,GrayPanthers,1,349,337,291,261,30,84,75,67,13,54,3
04-10-2022,ImpactTraining,2,221,176,108,34,74,90,27,38,0,38,1
04-10-2022,BitterLaser,1,272,131,116,51,65,84,28,15,7,8,0
04-10-2022,CelestialInterface,1,806,601,224,74,150,93,73,61,32,29,0
04-10-2022,ImpactTraining,1,570,106,435,275,160,90,16,41,9,32,1
04-10-2022,Aurora,1,116,47,88,55,33,67,45,17,0,17,1
04-10-2022,Mustangs,3,603,350,154,70,84,73,66,5,2,3,0
04-10-2023,Aurora,1,741,688,72,33,39,81,50,80,15,65,2
04-10-2023,CelestialInterface,3,913,151,563,133,430,87,44,36,21,15,2
04-10-2023,CelestialInterface,2,995,119,363,269,94,58,40,55,24,31,6
04-10-2023,Quicksilver,1,627,297,67,21,46,62,7,30,24,6,1
04-10-2023,BitterLaser,1,198,141,105,53,52,94,62,70,20,50,3
04-10-2023,GrayPanthers,3,310,225,229,6,223,97,65,23,13,10,0
04-10-2023,Honeycomb,2,344,127,69,50,19,67,37,31,30,1,1
04-10-2023,CelestialInterface,2,796,184,679,271,408,63,36,60,24,36,8
04-10-2023,Discovery,2,900,789,650,42,608,75,44,40,32,8,4
04-10-2023,PrimeSeven,2,310,204,219,194,25,89,66,85,57,28,8
04-10-2023,PrimeSeven,3,602,67,399,116,283,69,68,6,3,3,0
04-11-2021,PrimeSeven,3,636,213,30,13,17,85,48,60,53,7,2
04-11-2021,CelestialInterface,2,449,263,128,21,107,86,61,39,14,25,3
04-11-2021,ImpactTraining,1,495,219,94,52,42,76,30,67,13,54,7
04-11-2021,CelestialInterface,2,524,149,184,12,172,94,64,6,5,1,0
04-11-2021,Quicksilver,2,737,202,394,115,279,92,76,40,36,4,0
04-11-2021,Discovery,1,685,121,377,7,370,66,39,53,45,8,3
04-11-2021,ImpactTraining,2,831,417,144,46,98,56,29,6,3,3,0
04-11-2021,BitterLaser,3,895,62,90,54,36,93,37,2,1,1,0
04-11-2021,BitterLaser,2,569,463,261,77,184,54,47,51,38,13,3
04-11-2022,CelestialInterface,2,392,115,188,138,50,73,45,44,20,24,4
04-11-2022,Aurora,2,383,161,215,11,204,76,46,62,23,39,2
04-11-2022,Mustangs,2,550,509,306,201,105,99,23,85,55,30,0
04-11-2022,PrimeSeven,2,826,476,577,560,17,88,27,62,47,15,6
04-11-2022,Aurora,1,451,235,260,41,219,88,49,12,0,12,0
04-11-2022,ImpactTraining,3,365,129,230,224,6,58,18,3,0,3,0
04-11-2022,BitterLaser,2,575,557,314,248,66,54,50,28,8,20,0
04-11-2023,Honeycomb,2,467,83,259,49,210,58,4,38,13,25,0
04-11-2023,ImpactTraining,3,672,629,432,305,127,96,61,70,13,57,4
04-11-2023,Quicksilver,3,353,154,317,161,156,83,76,47,14,33,5
04-11-2023,ImpactTraining,2,177,76,80,79,1,64,38,49,24,25,4
04-11-2023,Aurora,3,375,70,173,22,151,100,25,84,37,47,3
04-11-2023,GrayPanthers,2,890,618,52,50,2,82,50,13,7,6,0
04-11-2023,CelestialInterface,2,197,101,27,26,1,72,14,25,9,16,1
04-11-2023,Mustangs,2,506,460,244,151,93,92,74,3,0,3,0
04-11-2023,Discovery,2,166,145,87,23,64,86,75,58,47,11,3
04-11-2023,BitterLaser,1,546,118,6,5,1,60,16,30,2,28,3
04-12-2021,CelestialInterface,1,656,471,188,158,30,61,27,13,4,9,0
04-12-2021,BitterLaser,2,239,97,169,4,165,55,7,15,6,9,1
04-12-2021,Discovery,2,348,57,241,212,29,78,18,32,23,9,3
04-12-2021,Discovery,1,475,52,135,124,11,50,22,29,1,28,1
04-12-2021,Mustangs,2,847,558,276,192,84,70,56,36,22,14,2
04-12-2021,Aurora,1,583,63,120,104,16,68,48,8,2,6,0
04-12-2021,Honeycomb,1,731,589,580,369,211,72,54,49,17,32,2
04-12-2021,BitterLaser,2,324,194,227,87,140,63,1,35,2,33,0
04-12-2021,CelestialInterface,1,473,344,157,36,121,87,6,31,10,21,2
04-12-2022,ImpactTraining,1,869,201,727,513,214,94,5,12,11,1,0
04-12-2022,ImpactTraining,3,134,7,49,44,5,91,38,26,21,5,0
04-12-2022,PrimeSeven,1,600,154,326,42,284,88,63,76,46,30,4
04-12-2022,Aurora,1,303,213,277,223,54,93,69,82,0,82,10
04-12-2022,Mustangs,2,116,20,110,87,23,86,38,6,4,2,0
04-12-2022,ImpactTraining,3,443,24,182,75,107,66,31,52,39,13,4
04-12-2022,CelestialInterface,2,170,159,66,2,64,99,88,97,40,57,3
04-12-2022,Mustangs,3,844,371,120,1,119,79,56,50,46,4,0
04-12-2023,GrayPanthers,1,253,237,230,30,200,77,71,44,1,43,5
04-12-2023,Aurora,1,303,117,49,14,35,66,36,47,6,41,3
04-12-2023,CelestialInterface,3,171,120,75,64,11,62,45,41,39,2,4
04-12-2023,Honeycomb,3,541,537,165,70,95,81,33,41,1,40,0
04-12-2023,Discovery,3,556,121,352,236,116,96,25,85,72,13,8
05-01-2021,Honeycomb,3,555,20,192,147,45,65,40,5,2,3,0
05-01-2021,Discovery,1,538,290,222,83,139,70,57,23,15,8,1
05-01-2021,Honeycomb,3,565,410,163,135,28,51,39,9,3,6,0
05-01-2021,BitterLaser,2,758,664,554,486,68,99,1,4,0,4,0
05-01-2021,Aurora,1,867,417,176,50,126,60,4,8,0,8,0
05-01-2021,Honeycomb,2,937,520,182,65,117,93,72,78,25,53,10
05-01-2021,ImpactTraining,1,579,464,515,502,13,72,69,15,5,10,1
05-01-2021,GrayPanthers,3,683,29,363,64,299,90,25,1,0,1,0
05-01-2022,BitterLaser,3,529,497,338,44,294,59,12,58,29,29,5
05-01-2022,Discovery,2,307,147,89,82,7,78,60,27,17,10,0
05-01-2022,CelestialInterface,1,277,102,148,55,93,96,28,20,18,2,2
05-01-2022,ImpactTraining,1,659,487,43,34,9,99,96,4,0,4,0
05-01-2022,CelestialInterface,1,183,104,4,1,3,72,30,10,8,2,0
05-01-2022,Quicksilver,1,358,188,269,50,219,53,41,34,30,4,3
05-01-2022,Quicksilver,1,898,174,474,40,434,97,31,79,42,37,5
05-01-2022,BitterLaser,3,515,231,505,205,300,98,17,32,3,29,0
05-01-2022,GrayPanthers,3,806,471,693,587,106,94,21,35,21,14,4
05-01-2022,Honeycomb,1,523,383,306,163,143,73,20,59,8,51,2
05-01-2022,PrimeSeven,1,749,715,215,38,177,92,2,29,27,2,3
05-01-2023,Mustangs,1,776,747,432,14,418,58,45,32,4,28,2
05-01-2023,Quicksilver,3,235,57,220,55,165,64,33,45,9,36,3
05-01-2023,Honeycomb,2,634,326,161,143,18,52,32,20,4,16,1
05-01-2023,Quicksilver,3,608,539,220,63,157,67,28,34,30,4,1
05-01-2023,PrimeSeven,3,539,363,270,132,138,68,46,56,37,19,6
05-01-2023,Discovery,1,651,89,388,81,307,61,43,44,6,38,1
05-01-2023,BitterLaser,2,236,49,106,48,58,71,53,2,1,1,0
05-01-2023,Discovery,2,512,505,19,11,8,55,32,47,5,42,3
05-02-2021,BitterLaser,3,320,234,67,37,30,74,65,49,27,22,4
05-02-2021,Quicksilver,1,575,79,284,76,208,51,39,34,15,19,1
05-02-2021,Quicksilver,1,355,159,222,54,168,100,37,7,2,5,0
05-02-2021,Aurora,2,737,118,281,158,123,82,73,34,11,23,1
05-02-2021,GrayPanthers,2,978,600,326,295,31,65,60,6,0,6,0
05-02-2021,Honeycomb,1,197,132,161,9,152,93,51,90,69,21,4
05-02-2021,BitterLaser,3,806,712,563,519,44,70,7,62,53,9,3
05-02-2021,Aurora,3,652,93,481,143,338,52,4,11,2,9,0
05-02-2022,Discovery,1,338,70,37,22,15,82,12,49,27,22,0
05-02-2022,Aurora,3,470,323,238,143,95,72,7,39,1,38,2
05-02-2022,CelestialInterface,2,316,279,61,12,49,64,8,45,41,4,3
05-02-2022,ImpactTraining,2,369,258,310,170,140,63,51,52,37,15,4
05-02-2022,CelestialInterface,2,666,252,238,22,216,99,82,40,38,2,3
05-02-2022,GrayPanthers,1,886,153,363,289,74,60,25,4,0,4,0
05-02-2022,PrimeSeven,1,791,322,545,267,278,57,12,15,1,14,1
05-02-2022,Discovery,2,507,422,106,23,83,56,11,21,5,16,2
05-02-2022,BitterLaser,3,174,37,152,61,91,66,43,43,40,3,0
05-02-2022,PrimeSeven,3,831,349,399,168,231,77,35,69,12,57,2
05-02-2022,Mustangs,3,512,405,312,172,140,85,4,66,56,10,6
05-02-2023,Discovery,3,320,115,310,248,62,76,65,53,25,28,6
05-02-2023,Aurora,3,996,304,746,151,595,65,52,44,42,2,5
05-02-2023,BitterLaser,2,557,96,81,79,2,98,57,57,31,26,2
05-02-2023,GrayPanthers,3,665,397,206,111,95,79,64,61,47,14,6
05-02-2023,PrimeSeven,3,619,564,508,202,306,61,15,41,13,28,1
05-02-2023,Honeycomb,1,683,11,378,118,260,58,22,5,1,4,0
05-02-2023,Aurora,2,297,143,45,2,43,87,2,36,11,25,1
05-02-2023,ImpactTraining,1,257,125,134,33,101,74,2,30,25,5,0
05-03-2021,ImpactTraining,1,643,508,386,304,82,83,44,12,2,10,0
05-03-2021,BitterLaser,3,603,196,593,384,209,94,85,67,33,34,3
05-03-2021,ImpactTraining,2,411,169,239,159,80,90,31,46,25,21,3
05-03-2021,Quicksilver,1,655,571,78,3,75,97,55,58,39,19,1
05-03-2021,BitterLaser,3,891,864,267,175,92,78,40,66,38,28,3
05-03-2021,ImpactTraining,2,766,436,557,275,282,60,17,26,18,8,2
05-03-2021,CelestialInterface,3,296,15,11,7,4,59,25,25,2,23,2
05-03-2021,Honeycomb,1,364,102,141,42,99,89,7,26,16,10,2
05-03-2022,Discovery,3,108,81,92,74,18,57,38,15,8,7,0
05-03-2022,Quicksilver,2,862,816,286,142,144,75,16,14,5,9,1
05-03-2022,Quicksilver,2,429,82,342,228,114,77,76,51,14,37,2
05-03-2022,ImpactTraining,2,258,189,174,88,86,96,23,84,31,53,6
05-03-2022,CelestialInterface,2,651,197,274,187,87,56,51,36,0,36,3
05-03-2022,ImpactTraining,1,613,115,199,79,120,57,23,27,2,25,1
05-03-2023,PrimeSeven,3,451,95,83,11,72,88,0,60,49,11,6
05-03-2023,ImpactTraining,2,131,82,84,72,12,62,60,47,9,38,2
05-03-2023,BitterLaser,1,855,555,306,267,39,97,43,42,1,41,3
05-03-2023,GrayPanthers,3,939,464,848,416,432,57,54,55,23,32,0
05-03-2023,Honeycomb,2,562,121,436,151,285,65,28,8,5,3,0
05-03-2023,PrimeSeven,3,116,100,113,81,32,55,34,27,25,2,1
05-03-2023,GrayPanthers,2,222,177,201,154,47,94,38,54,13,41,3
05-03-2023,Aurora,3,421,377,177,136,41,83,10,20,14,6,2
05-03-2023,Quicksilver,1,890,144,370,47,323,66,21,31,12,19,2
05-03-2023,BitterLaser,1,118,2,4,2,2,65,15,63,34,29,0
05-04-2021,ImpactTraining,2,120,89,62,44,18,50,3,31,2,29,3
05-04-2021,GrayPanthers,1,292,154,258,7,251,60,58,7,6,1,0
05-04-2021,Discovery,2,149,102,128,2,126,86,33,47,0,47,4
05-04-2021,GrayPanthers,1,460,422,110,95,15,63,35,51,10,41,3
05-04-2021,Quicksilver,2,907,854,282,91,191,73,6,3,0,3,0
05-04-2021,Quicksilver,2,688,277,199,94,105,65,54,62,50,12,4
05-04-2021,GrayPanthers,2,611,467,201,31,170,82,39,22,11,11,0
05-04-2021,Honeycomb,3,849,332,47,10,37,95,79,21,15,6,1
05-04-2021,Discovery,2,585,13,46,44,2,82,73,63,2,61,2
05-04-2021,Mustangs,1,377,65,1,0,1,95,28,1,0,1,0
05-04-2022,Mustangs,3,939,200,355,331,24,70,3,7,0,7,0
05-04-2022,GrayPanthers,2,242,213,232,126,106,68,27,12,2,10,0
05-04-2022,PrimeSeven,1,574,77,468,89,379,79,45,25,7,18,2
05-04-2022,Aurora,1,990,767,17,0,17,52,9,23,9,14,0
05-04-2022,PrimeSeven,1,709,490,222,108,114,80,21,69,36,33,4
05-04-2022,Mustangs,2,729,502,461,32,429,70,45,49,30,19,6
05-04-2022,BitterLaser,3,527,447,200,151,49,77,62,60,23,37,5
05-04-2022,Aurora,2,895,643,157,37,120,59,41,4,2,2,0
05-04-2022,Quicksilver,3,333,97,327,9,318,70,37,25,17,8,1
05-04-2023,ImpactTraining,3,798,383,183,36,147,57,48,41,38,3,4
05-04-2023,Honeycomb,2,201,199,150,86,64,74,54,73,16,57,9
05-04-2023,Discovery,2,884,354,342,27,315,87,26,36,17,19,2
05-04-2023,Mustangs,3,651,362,600,408,192,90,52,13,11,2,0
05-04-2023,PrimeSeven,2,616,186,262,66,196,94,31,77,7,70,5
05-04-2023,CelestialInterface,3,293,247,211,147,64,82,20,61,11,50,8
05-04-2023,Discovery,3,719,479,599,315,284,58,13,20,17,3,2
05-04-2023,Discovery,2,549,491,421,106,315,58,10,41,16,25,4
05-05-2021,Quicksilver,3,873,851,574,232,342,90,53,26,7,19,0
05-05-2021,Discovery,3,877,544,861,721,140,52,25,27,16,11,3
05-05-2021,Quicksilver,3,539,50,537,510,27,83,45,74,59,15,7
05-05-2021,Mustangs,2,525,151,159,100,59,68,53,49,40,9,5
05-05-2021,PrimeSeven,1,719,173,140,8,132,88,41,25,24,1,1
05-05-2021,Mustangs,2,675,619,104,4,100,67,44,44,27,17,5
05-05-2021,Quicksilver,3,349,348,151,125,26,95,80,9,5,4,0
05-05-2021,GrayPanthers,3,797,397,524,378,146,50,5,29,10,19,3
05-05-2022,GrayPanthers,2,490,380,56,29,27,62,3,47,24,23,5
05-05-2022,GrayPanthers,3,396,256,273,33,240,100,63,87,15,72,4
05-05-2022,CelestialInterface,1,135,29,47,37,10,64,0,61,40,21,2
05-05-2022,GrayPanthers,1,493,364,44,41,3,75,4,44,42,2,0
05-05-2022,Mustangs,2,948,357,254,52,202,91,90,22,21,1,0
05-05-2022,ImpactTraining,1,221,163,215,207,8,59,26,43,18,25,3
05-05-2023,Aurora,1,696,223,65,17,48,51,25,25,0,25,2
05-05-2023,CelestialInterface,1,901,537,258,1,257,84,68,67,35,32,4
05-05-2023,Mustangs,2,986,11,567,405,162,59,6,24,17,7,2
05-05-2023,Honeycomb,1,506,417,259,113,146,85,12,84,45,39,4
05-05-2023,PrimeSeven,2,675,426,240,197,43,59,35,1,0,1,0
05-05-2023,Honeycomb,2,318,112,174,126,48,72,25,62,5,57,5
05-05-2023,Discovery,3,245,8,199,144,55,99,70,62,52,10,6
05-05-2023,CelestialInterface,3,295,47,236,132,104,96,71,85,30,55,1
05-05-2023,Discovery,1,982,757,249,95,154,64,53,43,20,23,1
05-05-2023,CelestialInterface,3,929,589,554,285,269,67,49,60,56,4,4
05-06-2021,Quicksilver,1,526,3,331,140,191,59,46,0,0,0,0
05-06-2021,Discovery,3,896,857,565,434,131,91,38,25,21,4,1
05-06-2021,PrimeSeven,2,892,736,459,38,421,83,15,39,2,37,4
05-06-2021,GrayPanthers,1,800,594,349,254,95,83,59,20,13,7,0
05-06-2021,GrayPanthers,2,667,477,335,189,146,86,76,2,1,1,0
05-06-2021,ImpactTraining,1,969,211,448,321,127,80,6,58,22,36,3
05-06-2021,ImpactTraining,3,638,105,161,74,87,86,48,83,72,11,5
05-06-2021,Quicksilver,2,391,247,248,119,129,56,39,7,2,5,0
05-06-2021,PrimeSeven,3,449,231,117,111,6,97,17,40,29,11,4
05-06-2022,ImpactTraining,3,640,605,241,2,239,51,34,27,20,7,3
05-06-2022,ImpactTraining,3,723,387,642,302,340,96,94,8,5,3,0
05-06-2022,Aurora,1,727,531,414,355,59,65,47,25,7,18,1
05-06-2022,GrayPanthers,1,139,127,24,19,5,64,61,34,23,11,2
05-06-2022,PrimeSeven,3,851,277,123,85,38,61,58,35,10,25,3
05-06-2023,ImpactTraining,3,754,14,598,451,147,52,4,36,15,21,1
05-06-2023,Mustangs,2,697,604,145,85,60,83,80,10,6,4,0
05-06-2023,PrimeSeven,3,133,61,32,10,22,62,55,40,4,36,0
05-06-2023,Honeycomb,1,519,452,44,34,10,52,0,51,23,28,5
05-06-2023,GrayPanthers,1,502,335,306,68,238,83,20,21,2,19,1
05-06-2023,Honeycomb,1,189,7,14,4,10,91,1,37,0,37,0
05-06-2023,Mustangs,3,233,26,57,30,27,84,19,17,2,15,0
05-06-2023,ImpactTraining,3,595,557,455,171,284,50,12,39,32,7,2
05-06-2023,BitterLaser,1,548,153,117,76,41,68,11,27,23,4,2
05-07-2021,Discovery,3,528,82,171,144,27,80,48,23,12,11,1
05-07-2021,Aurora,3,841,670,449,17,432,66,35,64,11,53,2
05-07-2021,Honeycomb,3,366,300,231,20,211,90,64,15,3,12,0
05-07-2021,ImpactTraining,2,943,925,786,528,258,96,54,0,0,0,0
05-07-2021,Honeycomb,3,363,158,88,61,27,76,2,57,43,14,2
05-07-2021,Discovery,3,100,67,23,19,4,58,20,28,10,18,1
05-07-2021,PrimeSeven,2,805,802,202,172,30,100,23,40,1,39,5
05-07-2021,Mustangs,3,334,55,310,237,73,73,69,52,31,21,4
05-07-2021,GrayPanthers,2,321,101,139,62,77,80,34,43,24,19,2
05-07-2022,BitterLaser,2,940,14,820,185,635,66,4,36,24,12,3
05-07-2022,ImpactTraining,3,977,437,967,711,256,53,52,49,19,30,2
05-07-2022,Quicksilver,2,517,69,1,0,1,78,67,9,2,7,0
05-07-2022,BitterLaser,3,190,167,164,144,20,79,27,34,25,9,3
05-07-2022,Discovery,3,428,362,391,348,43,96,51,56,2,54,4
05-07-2022,ImpactTraining,3,726,666,392,312,80,93,42,10,2,8,0
05-07-2022,CelestialInterface,1,198,93,59,31,28,91,67,86,67,19,5
05-07-2022,BitterLaser,2,357,214,6,2,4,63,46,40,26,14,4
05-07-2022,Mustangs,3,156,67,29,23,6,76,18,61,36,25,2
05-07-2022,ImpactTraining,1,647,641,268,103,165,95,11,31,8,23,0
05-07-2023,Honeycomb,2,268,225,228,81,147,100,14,45,36,9,2
05-07-2023,PrimeSeven,1,549,206,280,181,99,67,29,15,7,8,1
05-07-2023,Mustangs,3,142,119,30,15,15,66,64,43,38,5,3
05-07-2023,ImpactTraining,2,602,17,8,7,1,75,65,49,16,33,0
05-07-2023,PrimeSeven,3,400,282,238,234,4,70,3,13,4,9,0
05-07-2023,CelestialInterface,2,904,88,223,222,1,60,24,33,30,3,3
05-07-2023,BitterLaser,2,478,436,21,14,7,77,44,68,36,32,1
05-07-2023,Discovery,3,658,278,294,189,105,84,72,35,26,9,2
05-07-2023,BitterLaser,2,826,243,398,367,31,73,11,45,24,21,5
05-07-2023,Honeycomb,2,251,51,222,88,134,87,21,26,18,8,1
05-07-2023,CelestialInterface,2,784,63,670,561,109,55,40,11,8,3,0
05-08-2021,Honeycomb,3,238,143,3,1,2,95,42,39,5,34,0
05-08-2021,BitterLaser,3,403,357,121,118,3,88,11,44,20,24,4
05-08-2021,Mustangs,2,716,649,54,48,6,51,44,20,12,8,1
05-08-2021,ImpactTraining,3,791,25,461,47,414,64,49,27,8,19,2
05-08-2021,Aurora,3,117,83,26,1,25,76,9,42,19,23,4
05-08-2021,BitterLaser,2,763,95,206,15,191,82,0,39,36,3,1
05-08-2021,BitterLaser,2,128,17,43,17,26,55,15,48,27,21,4
05-08-2021,Honeycomb,2,870,415,778,4,774,99,32,94,72,22,8
05-08-2021,CelestialInterface,3,419,173,74,62,12,96,79,35,14,21,4
05-08-2021,Aurora,1,688,512,516,166,350,73,33,45,7,38,2
05-08-2021,Aurora,2,842,57,713,455,258,83,43,78,60,18,8
05-08-2021,ImpactTraining,1,949,706,56,24,32,61,7,59,11,48,5
05-08-2021,Discovery,3,336,87,171,28,143,90,18,18,16,2,1
05-08-2021,GrayPanthers,1,444,70,301,0,301,82,69,3,2,1,0
05-08-2022,PrimeSeven,3,486,270,310,279,31,87,82,15,14,1,1
05-08-2022,CelestialInterface,3,300,251,268,228,40,70,59,65,61,4,1
05-08-2022,ImpactTraining,2,487,24,384,155,229,93,22,40,31,9,3
05-08-2022,Discovery,1,370,218,333,222,111,79,6,26,24,2,2
05-08-2022,Discovery,1,452,282,388,97,291,87,38,14,0,14,1
05-08-2022,CelestialInterface,1,957,665,282,30,252,52,29,31,25,6,0
05-08-2022,Quicksilver,2,129,6,14,11,3,79,64,32,8,24,0
05-08-2022,PrimeSeven,3,939,137,359,142,217,91,42,61,31,30,8
05-08-2022,CelestialInterface,1,771,729,705,606,99,53,1,12,0,12,0
05-08-2022,CelestialInterface,3,108,47,89,35,54,57,49,15,11,4,0
05-08-2022,Quicksilver,2,700,6,339,109,230,70,56,59,40,19,6
05-08-2022,PrimeSeven,3,951,0,355,16,339,81,56,27,1,26,2
05-08-2022,PrimeSeven,2,676,329,373,138,235,56,45,38,3,35,2
05-08-2023,Mustangs,3,143,27,1,0,1,54,39,4,3,1,0
05-08-2023,Quicksilver,3,668,452,515,114,401,54,3,36,30,6,3
05-08-2023,Mustangs,2,555,57,203,160,43,88,48,55,36,19,1
05-08-2023,Honeycomb,2,572,222,78,39,39,58,4,12,7,5,0
05-08-2023,Honeycomb,3,292,241,164,38,126,68,39,20,14,6,0
05-08-2023,Discovery,1,205,5,168,87,81,58,4,54,20,34,6
05-08-2023,Quicksilver,1,882,452,11,9,2,62,2,5,0,5,0
05-08-2023,BitterLaser,3,337,243,261,224,37,53,44,11,7,4,0
05-08-2023,Honeycomb,2,147,47,62,4,58,83,42,78,73,5,1
05-08-2023,CelestialInterface,2,807,292,321,119,202,79,14,43,28,15,0
05-09-2021,Discovery,3,835,493,636,265,371,94,32,46,24,22,2
05-09-2021,Mustangs,3,933,630,554,496,58,56,2,29,4,25,3
05-09-2021,CelestialInterface,2,923,408,28,24,4,82,40,70,66,4,4
05-09-2021,PrimeSeven,2,561,252,452,174,278,90,12,85,45,40,11
05-09-2021,Honeycomb,3,361,18,238,130,108,98,63,24,11,13,2
05-09-2021,Quicksilver,2,294,0,106,61,45,98,39,73,2,71,5
05-09-2021,BitterLaser,2,722,576,143,91,52,100,55,37,2,35,4
05-09-2021,Honeycomb,3,486,319,249,115,134,73,28,24,4,20,0
05-09-2021,Honeycomb,3,483,85,85,77,8,83,23,41,24,17,0
05-09-2022,GrayPanthers,1,759,252,560,211,349,76,41,74,11,63,7
05-09-2022,Mustangs,1,818,672,500,371,129,55,7,32,13,19,0
05-09-2022,Quicksilver,2,444,320,59,48,11,99,69,96,76,20,13
05-09-2022,ImpactTraining,3,647,40,292,27,265,66,25,46,12,34,5
05-09-2022,GrayPanthers,1,210,14,96,86,10,81,41,57,14,43,0
05-09-2022,Mustangs,3,992,166,377,46,331,75,51,1,0,1,0
05-09-2022,PrimeSeven,3,135,5,43,11,32,80,4,5,3,2,0
05-09-2022,Aurora,1,830,582,539,278,261,81,22,72,57,15,9
05-09-2022,Honeycomb,2,462,210,432,56,376,93,85,15,11,4,0
05-09-2022,Discovery,1,477,278,472,457,15,53,36,31,13,18,3
05-09-2022,Mustangs,3,149,80,101,39,62,65,60,3,2,1,0
05-09-2022,GrayPanthers,2,853,454,336,65,271,66,29,20,10,10,2
05-09-2023,ImpactTraining,1,754,264,288,94,194,50,11,39,29,10,3
05-09-2023,BitterLaser,2,820,361,177,170,7,99,85,82,43,39,6
05-09-2023,Quicksilver,1,360,269,71,42,29,92,37,8,5,3,0
05-09-2023,Mustangs,2,637,582,240,119,121,95,62,79,53,26,9
05-09-2023,Discovery,2,310,297,39,11,28,60,36,28,11,17,1
05-09-2023,ImpactTraining,2,345,188,142,32,110,83,6,29,5,24,0
05-10-2021,Aurora,1,151,105,60,59,1,98,57,19,11,8,1
05-10-2021,Quicksilver,3,458,312,450,402,48,89,6,26,0,26,1
05-10-2021,CelestialInterface,3,674,226,510,380,130,99,45,47,43,4,0
05-10-2021,Quicksilver,3,831,671,182,148,34,65,45,13,8,5,0
05-10-2021,Mustangs,3,784,319,218,173,45,77,54,7,5,2,0
05-10-2021,PrimeSeven,1,997,913,567,399,168,59,4,15,9,6,1
05-10-2021,Aurora,1,434,399,247,182,65,54,6,29,23,6,1
05-10-2021,ImpactTraining,2,270,241,261,101,160,100,38,78,36,42,3
05-10-2021,CelestialInterface,1,631,184,447,202,245,78,59,7,4,3,0
05-10-2021,GrayPanthers,3,756,476,435,415,20,55,26,48,25,23,0
05-10-2021,Quicksilver,1,825,561,470,116,354,76,56,72,15,57,4
05-10-2021,Aurora,3,415,327,146,107,39,78,65,62,36,26,3
05-10-2022,ImpactTraining,1,871,597,758,239,519,77,40,46,21,25,2
05-10-2022,GrayPanthers,1,659,297,146,79,67,86,29,35,32,3,1
05-10-2022,Discovery,2,553,349,27,13,14,77,7,72,15,57,8
05-10-2022,ImpactTraining,3,136,132,46,10,36,66,7,2,1,1,0
05-10-2022,PrimeSeven,1,996,558,375,256,119,96,55,28,25,3,1
05-10-2022,Mustangs,1,241,135,178,162,16,55,45,15,1,14,0
05-10-2022,Mustangs,2,991,291,922,9,913,99,31,11,8,3,0
05-10-2022,Mustangs,3,727,244,65,20,45,97,10,16,5,11,1
05-10-2022,Aurora,3,598,435,150,33,117,77,23,28,18,10,0
05-10-2023,Aurora,2,153,58,14,5,9,54,7,47,5,42,6
05-10-2023,BitterLaser,2,176,144,100,0,100,63,55,5,0,5,0
05-10-2023,Honeycomb,2,980,286,468,15,453,58,33,30,21,9,2
05-10-2023,GrayPanthers,1,877,285,286,121,165,95,4,10,3,7,0
05-10-2023,Discovery,3,681,592,391,276,115,57,54,18,12,6,0
05-10-2023,PrimeSeven,1,183,151,19,6,13,82,13,3,0,3,0
05-10-2023,ImpactTraining,3,344,307,73,36,37,100,43,25,9,16,0
05-10-2023,CelestialInterface,1,731,409,255,152,103,97,70,79,30,49,7
05-10-2023,Mustangs,3,417,100,163,50,113,94,79,41,22,19,0
05-10-2023,Discovery,2,883,706,288,213,75,68,17,61,56,5,1
05-10-2023,Mustangs,1,472,151,231,75,156,94,31,17,16,1,1
05-10-2023,BitterLaser,3,571,75,460,372,88,57,34,19,6,13,1
05-10-2023,Mustangs,3,597,457,214,162,52,70,46,33,20,13,2
05-10-2023,BitterLaser,2,919,403,594,16,578,77,45,31,5,26,0
05-10-2023,Mustangs,1,433,338,343,180,163,96,23,26,7,19,0
05-10-2023,ImpactTraining,3,854,305,751,545,206,51,4,19,3,16,1
05-10-2023,Quicksilver,3,659,84,493,490,3,50,21,5,3,2,0
05-10-2023,Discovery,1,922,356,25,1,24,69,64,21,5,16,1
05-10-2023,CelestialInterface,3,472,461,281,110,171,60,25,34,4,30,4
05-11-2021,PrimeSeven,2,298,72,40,8,32,87,65,35,5,30,4
05-11-2021,Quicksilver,3,390,60,147,54,93,70,63,61,38,23,6
05-11-2021,PrimeSeven,1,757,29,106,51,55,50,7,8,2,6,0
05-11-2021,Honeycomb,2,432,364,8,7,1,54,36,12,6,6,0
05-11-2021,Mustangs,1,751,544,139,60,79,75,34,37,30,7,4
05-11-2021,GrayPanthers,2,611,322,257,36,221,58,16,5,3,2,0
05-11-2021,Aurora,3,395,187,338,167,171,90,43,8,4,4,0
05-11-2021,BitterLaser,1,750,216,182,43,139,70,61,34,19,15,3
05-11-2021,ImpactTraining,2,218,209,22,10,12,61,60,47,12,35,6
05-11-2021,CelestialInterface,1,611,367,608,495,113,75,11,37,27,10,1
05-11-2021,Aurora,1,210,163,187,14,173,78,52,59,35,24,0
05-11-2021,PrimeSeven,2,333,268,113,41,72,85,60,67,34,33,5
05-11-2022,BitterLaser,3,460,59,394,222,172,57,21,9,4,5,0
05-11-2022,Discovery,1,950,433,376,75,301,99,92,69,56,13,2
05-11-2022,BitterLaser,2,591,212,460,363,97,55,39,2,1,1,0
05-11-2022,ImpactTraining,1,567,106,431,168,263,86,35,57,30,27,4
05-11-2022,Mustangs,3,864,796,624,217,407,87,39,35,15,20,1
05-11-2022,Aurora,2,623,190,430,2,428,88,23,46,22,24,3
05-11-2022,Discovery,3,614,292,224,49,175,83,12,21,5,16,0
05-11-2023,CelestialInterface,2,965,573,508,32,476,80,46,27,17,10,1
05-11-2023,Quicksilver,3,334,245,311,43,268,95,23,74,22,52,10
05-11-2023,Quicksilver,1,695,232,499,102,397,66,9,8,3,5,0
05-11-2023,Mustangs,2,182,7,157,104,53,100,20,70,41,29,8
05-11-2023,ImpactTraining,2,337,217,113,98,15,97,36,22,8,14,0
05-12-2021,Quicksilver,1,701,412,326,68,258,75,56,19,11,8,1
05-12-2021,Aurora,2,299,238,7,5,2,94,55,83,70,13,2
05-12-2021,Aurora,2,156,6,41,40,1,82,3,66,31,35,8
05-12-2021,Honeycomb,3,179,109,35,34,1,85,28,37,12,25,0
05-12-2021,Quicksilver,3,207,113,72,0,72,94,71,51,34,17,5
05-12-2021,Quicksilver,3,712,36,516,77,439,57,30,12,4,8,0
05-12-2021,BitterLaser,2,875,793,699,424,275,77,53,62,43,19,3
05-12-2021,BitterLaser,1,136,104,121,47,74,99,77,53,24,29,0
05-12-2021,Honeycomb,3,272,32,256,201,55,71,34,57,3,54,7
05-12-2021,Honeycomb,3,743,579,585,75,510,81,68,12,2,10,0
05-12-2021,Mustangs,2,783,78,446,269,177,71,36,32,15,17,2
05-12-2022,Aurora,3,438,257,97,32,65,57,46,3,2,1,0
05-12-2022,Aurora,1,476,27,179,91,88,59,50,21,4,17,0
05-12-2022,Honeycomb,2,498,264,250,131,119,71,26,59,43,16,5
05-12-2022,Mustangs,1,616,387,594,116,478,76,31,46,15,31,4
05-12-2022,Discovery,3,733,638,2,0,2,80,56,61,37,24,2
05-12-2022,BitterLaser,3,441,67,259,145,114,90,48,71,49,22,0
05-12-2022,GrayPanthers,2,586,347,52,12,40,54,9,23,7,16,0
05-12-2022,Aurora,2,251,25,134,98,36,70,66,41,38,3,3
05-12-2022,GrayPanthers,2,357,144,182,136,46,58,30,0,0,0,0
05-12-2023,GrayPanthers,1,121,56,61,15,46,58,57,27,7,20,3
05-12-2023,Mustangs,1,534,244,37,27,10,59,10,14,5,9,1
05-12-2023,Honeycomb,1,698,35,307,197,110,71,56,0,0,0,0
05-12-2023,Discovery,3,496,196,324,119,205,60,9,37,33,4,1
05-12-2023,PrimeSeven,2,708,527,591,92,499,67,1,13,2,11,0
05-12-2023,GrayPanthers,3,805,433,16,12,4,100,56,13,7,6,0
05-12-2023,ImpactTraining,3,202,62,75,8,67,98,68,67,7,60,8
05-12-2023,Honeycomb,1,148,97,80,21,59,87,5,31,30,1,2
05-12-2023,Honeycomb,3,566,121,181,124,57,93,83,49,31,18,3
05-12-2023,Honeycomb,3,484,77,130,26,104,90,31,37,16,21,4
06-01-2021,Quicksilver,1,424,391,324,258,66,62,32,5,3,2,0
06-01-2021,Aurora,3,777,766,665,129,536,96,48,16,13,3,1
06-01-2021,Aurora,3,154,51,120,53,67,50,13,46,13,33,2
06-01-2021,Mustangs,2,490,428,0,0,0,98,81,72,6,66,5
06-01-2021,CelestialInterface,2,512,358,241,238,3,52,29,39,15,24,1
06-01-2021,Aurora,3,209,157,133,15,118,78,1,47,43,4,3
06-01-2021,Discovery,3,743,416,248,159,89,70,2,39,10,29,4
06-01-2021,Aurora,3,514,481,223,102,121,83,71,63,22,41,1
06-01-2022,GrayPanthers,2,713,495,262,222,40,64,50,4,3,1,0
06-01-2022,Honeycomb,2,316,249,119,21,98,82,32,13,7,6,0
06-01-2022,GrayPanthers,1,758,334,350,53,297,62,7,53,38,15,2
06-01-2022,Quicksilver,3,163,49,98,53,45,72,32,4,0,4,0
06-01-2022,ImpactTraining,2,869,468,754,364,390,68,4,13,3,10,0
06-01-2022,Discovery,3,803,352,363,164,199,92,17,78,32,46,1
06-01-2022,ImpactTraining,1,496,364,120,69,51,80,22,58,48,10,4
06-01-2022,PrimeSeven,3,202,67,9,7,2,94,81,59,50,9,1
06-01-2022,Mustangs,1,479,84,119,68,51,95,38,73,39,34,4
06-01-2022,CelestialInterface,1,139,12,115,35,80,82,60,35,25,10,3
06-01-2023,Aurora,1,658,352,52,32,20,53,7,21,8,13,1
06-01-2023,Aurora,1,518,11,220,159,61,65,64,54,37,17,0
06-01-2023,Quicksilver,3,858,698,714,234,480,90,12,63,2,61,1
06-01-2023,Aurora,1,255,191,134,21,113,97,59,76,24,52,0
06-01-2023,Aurora,3,836,211,186,121,65,70,6,67,26,41,5
06-01-2023,Aurora,3,803,553,137,9,128,86,26,34,5,29,3
06-01-2023,ImpactTraining,3,940,288,265,125,140,64,6,32,0,32,0
06-01-2023,Quicksilver,2,533,437,5,1,4,60,31,54,24,30,2
06-02-2021,ImpactTraining,2,590,65,541,511,30,80,74,56,44,12,4
06-02-2021,Discovery,3,669,561,573,500,73,51,16,27,19,8,3
06-02-2021,Discovery,2,806,785,150,139,11,76,64,75,54,21,0
06-02-2021,Aurora,2,237,121,148,118,30,67,39,34,6,28,2
06-02-2021,Honeycomb,3,525,430,208,101,107,59,2,18,16,2,1
06-02-2021,PrimeSeven,1,563,425,80,72,8,100,97,74,58,16,6
06-02-2021,BitterLaser,1,188,116,181,148,33,63,39,45,8,37,1
06-02-2021,BitterLaser,3,667,364,202,186,16,62,9,3,1,2,0
06-02-2021,Quicksilver,3,704,596,537,79,458,64,14,21,12,9,2
06-02-2021,ImpactTraining,1,149,91,129,40,89,72,5,7,0,7,0
06-02-2022,PrimeSeven,2,656,599,542,207,335,58,17,8,5,3,0
06-02-2022,Mustangs,2,703,557,371,47,324,53,42,21,20,1,0
06-02-2022,CelestialInterface,2,177,146,76,20,56,87,47,58,48,10,4
06-02-2022,Discovery,3,821,498,654,386,268,76,46,53,41,12,6
06-02-2022,CelestialInterface,1,368,266,194,146,48,51,2,3,1,2,0
06-02-2022,Discovery,2,343,147,259,147,112,82,44,54,15,39,7
06-02-2023,Honeycomb,1,942,748,323,229,94,53,27,37,10,27,3
06-02-2023,Mustangs,3,591,409,99,71,28,65,16,32,5,27,1
06-02-2023,BitterLaser,3,353,137,346,52,294,81,32,72,11,61,3
06-02-2023,PrimeSeven,3,538,142,148,35,113,94,51,24,20,4,0
06-02-2023,Mustangs,1,950,216,325,168,157,61,55,13,7,6,0
06-02-2023,ImpactTraining,1,266,97,35,12,23,89,11,49,32,17,3
06-02-2023,ImpactTraining,1,443,333,417,285,132,97,62,43,37,6,2
06-02-2023,GrayPanthers,2,489,153,203,52,151,77,55,56,8,48,7
06-02-2023,Quicksilver,2,941,193,143,99,44,74,31,33,21,12,2
06-02-2023,Mustangs,1,854,288,233,109,124,51,42,17,11,6,0
06-03-2021,GrayPanthers,2,270,233,265,18,247,89,40,13,4,9,0
06-03-2021,BitterLaser,2,485,65,155,102,53,91,55,3,2,1,0
06-03-2022,PrimeSeven,2,925,905,859,785,74,93,38,30,16,14,0
06-03-2022,GrayPanthers,2,537,244,127,53,74,82,0,24,7,17,0
06-03-2022,Mustangs,2,586,516,541,93,448,70,48,42,23,19,1
06-03-2022,Mustangs,3,510,151,125,29,96,71,32,68,30,38,5
06-03-2022,Discovery,2,759,256,96,35,61,86,63,46,16,30,4
06-03-2022,Aurora,3,850,723,719,315,404,88,36,34,17,17,1
06-03-2022,Quicksilver,1,377,146,73,48,25,51,19,31,28,3,0
06-03-2022,Aurora,2,329,58,116,109,7,94,45,93,59,34,8
06-03-2022,CelestialInterface,1,835,339,238,113,125,83,78,68,49,19,7
06-03-2022,PrimeSeven,1,941,538,612,442,170,87,37,21,13,8,0
06-03-2022,PrimeSeven,1,500,461,328,156,172,98,92,63,30,33,4
06-03-2023,Mustangs,2,401,28,65,27,38,75,70,15,1,14,1
06-03-2023,Honeycomb,3,784,228,281,271,10,85,32,75,72,3,2
06-03-2023,BitterLaser,3,406,214,167,110,57,72,64,32,10,22,1
06-03-2023,ImpactTraining,2,375,297,240,181,59,65,40,40,35,5,2
06-03-2023,Quicksilver,1,236,60,146,103,43,96,88,68,40,28,3
06-03-2023,BitterLaser,1,953,580,312,148,164,53,41,30,28,2,1
06-03-2023,Discovery,3,681,475,5,4,1,70,11,34,16,18,1
06-03-2023,CelestialInterface,3,340,118,137,92,45,84,11,51,24,27,1
06-03-2023,Aurora,2,259,78,186,61,125,99,42,30,27,3,3
06-03-2023,Quicksilver,3,384,36,98,71,27,88,52,58,4,54,3
06-03-2023,Mustangs,3,111,56,27,25,2,69,56,39,25,14,3
06-03-2023,Honeycomb,3,673,123,383,136,247,98,80,85,51,34,9
06-04-2021,Mustangs,2,378,50,253,111,142,88,40,54,45,9,0
06-04-2021,Aurora,3,783,553,21,13,8,100,44,36,2,34,3
06-04-2021,GrayPanthers,2,680,652,191,68,123,99,53,22,17,5,2
06-04-2021,Honeycomb,3,446,57,91,42,49,62,35,35,25,10,2
06-04-2021,Discovery,2,351,264,282,15,267,93,89,80,76,4,6
06-04-2021,Mustangs,1,829,671,445,278,167,96,95,76,60,16,9
06-04-2021,PrimeSeven,3,404,382,103,98,5,73,10,25,18,7,1
06-04-2021,BitterLaser,2,292,37,106,99,7,50,44,23,11,12,1
06-04-2021,Mustangs,2,271,218,248,54,194,71,53,9,7,2,0
06-04-2021,Discovery,2,927,240,19,0,19,77,56,35,20,15,3
06-04-2021,Discovery,2,789,329,390,300,90,95,66,11,9,2,0
06-04-2021,Honeycomb,3,308,144,169,128,41,63,18,33,26,7,3
06-04-2021,ImpactTraining,2,637,218,46,15,31,67,34,63,61,2,8
06-04-2021,Discovery,3,963,510,589,208,381,51,34,33,14,19,1
06-04-2022,Discovery,2,147,106,140,83,57,65,58,55,34,21,3
06-04-2022,Quicksilver,2,907,757,676,615,61,66,11,2,0,2,0
06-04-2022,GrayPanthers,2,919,726,883,763,120,98,19,45,4,41,4
06-04-2022,GrayPanthers,2,804,205,575,233,342,87,81,36,10,26,0
06-04-2022,Aurora,3,848,578,85,71,14,89,65,75,33,42,4
06-04-2022,GrayPanthers,2,897,423,880,722,158,100,10,69,18,51,6
06-04-2022,GrayPanthers,2,176,133,6,3,3,90,5,19,9,10,1
06-04-2022,Quicksilver,2,563,419,63,8,55,89,69,22,8,14,0
06-04-2022,BitterLaser,2,660,495,10,5,5,60,59,47,3,44,1
06-04-2022,GrayPanthers,2,635,7,47,30,17,77,6,42,28,14,0
06-04-2022,Quicksilver,1,215,128,148,142,6,70,18,45,13,32,1
06-04-2022,BitterLaser,1,254,184,91,25,66,96,31,30,20,10,1
06-04-2022,CelestialInterface,2,385,223,127,103,24,60,6,26,3,23,2
06-04-2022,Discovery,2,326,180,197,190,7,80,26,42,22,20,0
06-04-2022,Honeycomb,1,147,92,53,12,41,90,37,24,2,22,1
06-04-2023,GrayPanthers,1,798,362,791,75,716,68,42,5,4,1,0
06-04-2023,ImpactTraining,1,100,64,24,10,14,67,22,44,42,2,2
06-04-2023,GrayPanthers,2,195,63,124,45,79,72,45,54,18,36,5
06-04-2023,Discovery,1,685,594,1,0,1,69,51,58,12,46,4
06-04-2023,Aurora,2,677,4,298,179,119,64,14,24,2,22,2
06-04-2023,Honeycomb,2,202,56,112,96,16,96,62,38,26,12,3
06-04-2023,GrayPanthers,3,943,772,676,61,615,83,44,73,19,54,2
06-04-2023,PrimeSeven,3,602,170,278,144,134,60,41,9,1,8,0
06-04-2023,ImpactTraining,3,690,448,315,18,297,79,46,75,49,26,4
06-04-2023,Aurora,1,220,216,71,22,49,68,45,44,29,15,2
06-04-2023,Aurora,1,899,307,737,218,519,88,59,24,14,10,0
06-04-2023,BitterLaser,3,193,46,108,11,97,97,87,74,10,64,9
06-04-2023,Discovery,1,222,149,129,6,123,55,43,27,16,11,0
06-05-2021,Mustangs,1,152,104,53,36,17,78,36,41,6,35,1
06-05-2021,BitterLaser,1,604,354,448,16,432,56,8,53,33,20,6
06-05-2021,Quicksilver,2,888,155,148,119,29,98,10,5,4,1,0
06-05-2021,Honeycomb,3,728,164,301,259,42,100,61,63,2,61,4
06-05-2021,PrimeSeven,1,565,234,178,4,174,67,64,58,29,29,2
06-05-2021,GrayPanthers,2,271,202,220,26,194,54,47,37,24,13,4
06-05-2022,ImpactTraining,3,819,138,676,438,238,56,34,23,12,11,1
06-05-2022,Aurora,3,266,142,12,9,3,99,2,10,8,2,0
06-05-2022,BitterLaser,3,260,171,75,14,61,75,45,42,24,18,1
06-05-2022,Quicksilver,2,113,85,107,74,33,59,1,36,4,32,1
06-05-2022,Aurora,2,234,173,184,140,44,50,34,48,44,4,0
06-05-2022,Quicksilver,3,533,56,518,296,222,76,6,69,30,39,6
06-05-2022,Discovery,3,551,186,245,59,186,99,17,83,54,29,5
06-05-2022,Quicksilver,3,192,34,21,0,21,50,4,17,5,12,1
06-05-2022,Discovery,3,450,394,378,373,5,54,5,51,15,36,5
06-05-2022,GrayPanthers,3,341,134,77,75,2,74,63,62,61,1,8
06-05-2023,ImpactTraining,3,329,118,52,13,39,50,7,33,7,26,3
06-05-2023,PrimeSeven,2,130,112,72,18,54,50,45,23,5,18,0
06-05-2023,PrimeSeven,3,598,265,105,25,80,57,15,18,14,4,1
06-05-2023,BitterLaser,2,215,42,136,66,70,91,80,51,29,22,3
06-05-2023,PrimeSeven,1,868,597,230,219,11,64,45,57,13,44,3
06-05-2023,BitterLaser,1,155,143,134,50,84,51,50,29,19,10,1
06-05-2023,Aurora,3,998,312,896,726,170,60,39,21,14,7,0
06-05-2023,BitterLaser,3,335,72,251,228,23,65,10,13,2,11,0
06-05-2023,PrimeSeven,1,250,111,113,9,104,69,3,28,14,14,3
06-06-2021,CelestialInterface,1,987,846,561,332,229,84,54,47,14,33,2
06-06-2021,Discovery,1,619,47,579,113,466,51,33,24,14,10,2
06-06-2021,BitterLaser,2,340,231,179,10,169,53,23,18,12,6,1
06-06-2021,PrimeSeven,3,778,692,541,71,470,65,55,17,0,17,0
06-06-2021,CelestialInterface,3,959,80,349,269,80,87,59,55,0,55,5
06-06-2021,PrimeSeven,3,982,687,171,61,110,96,50,22,1,21,0
06-06-2022,ImpactTraining,3,382,45,32,0,32,67,25,34,1,33,0
06-06-2022,ImpactTraining,3,322,233,183,98,85,68,4,67,48,19,9
06-06-2022,CelestialInterface,2,530,442,374,165,209,61,3,15,7,8,1
06-06-2022,Honeycomb,3,577,11,393,218,175,78,8,47,6,41,3
06-06-2022,ImpactTraining,1,447,197,72,47,25,60,56,45,16,29,0
06-06-2022,Quicksilver,2,566,446,53,12,41,88,1,53,43,10,3
06-06-2022,CelestialInterface,2,842,805,202,193,9,58,31,31,3,28,3
06-06-2022,GrayPanthers,1,548,475,270,225,45,100,1,86,53,33,1
06-06-2022,ImpactTraining,1,213,111,21,12,9,93,51,78,77,1,2
06-06-2022,Discovery,2,308,96,84,13,71,92,74,1,0,1,0
06-06-2022,Mustangs,3,776,327,363,0,363,51,50,48,40,8,3
06-06-2022,Aurora,1,790,178,248,6,242,97,36,37,28,9,4
06-06-2022,GrayPanthers,3,619,368,535,141,394,66,22,32,5,27,3
06-06-2022,GrayPanthers,1,811,756,207,153,54,83,36,33,7,26,2
06-06-2022,Aurora,3,157,155,117,30,87,76,11,27,15,12,1
06-06-2023,Aurora,2,620,276,30,18,12,54,9,40,33,7,3
06-06-2023,Discovery,3,650,266,56,18,38,98,4,1,0,1,0
06-06-2023,Quicksilver,1,497,281,471,200,271,70,37,55,34,21,4
06-06-2023,BitterLaser,1,103,38,38,34,4,59,0,32,18,14,1
06-06-2023,Aurora,2,761,356,306,304,2,87,71,49,13,36,6
06-06-2023,BitterLaser,3,663,516,291,54,237,86,43,23,0,23,0
06-06-2023,Discovery,2,927,341,688,434,254,96,28,71,21,50,6
06-06-2023,BitterLaser,2,645,414,192,13,179,72,34,14,11,3,1
06-06-2023,CelestialInterface,1,595,13,184,6,178,73,3,12,2,10,0
06-07-2021,Discovery,2,920,739,874,841,33,59,9,16,5,11,0
06-07-2021,Quicksilver,2,528,400,77,16,61,85,72,37,25,12,2
06-07-2021,PrimeSeven,3,612,192,302,196,106,69,40,61,26,35,8
06-07-2021,Quicksilver,3,903,277,868,487,381,88,54,13,6,7,0
06-07-2021,Quicksilver,1,196,70,15,0,15,50,48,15,11,4,1
06-07-2021,CelestialInterface,1,794,47,347,171,176,66,29,23,7,16,0
06-07-2021,Aurora,3,877,137,866,668,198,72,39,29,5,24,3
06-07-2021,ImpactTraining,1,839,699,725,199,526,83,77,30,3,27,1
06-07-2022,Quicksilver,3,585,538,29,16,13,75,15,63,46,17,8
06-07-2022,Discovery,2,612,92,122,62,60,61,50,13,1,12,0
06-07-2022,Discovery,3,291,151,158,103,55,88,35,19,6,13,0
06-07-2022,PrimeSeven,3,258,189,191,114,77,77,33,4,3,1,0
06-07-2022,ImpactTraining,3,723,495,515,73,442,70,19,61,25,36,7
06-07-2022,ImpactTraining,2,689,233,133,66,67,78,5,9,4,5,0
06-07-2022,BitterLaser,3,992,459,181,22,159,72,65,52,32,20,1
06-07-2022,PrimeSeven,1,560,417,275,56,219,50,37,49,6,43,6
06-07-2022,BitterLaser,3,118,16,95,25,70,99,7,95,28,67,12
06-07-2022,Mustangs,1,820,158,80,26,54,51,3,14,1,13,0
06-07-2022,Aurora,1,201,64,132,70,62,90,16,63,44,19,0
06-07-2022,ImpactTraining,2,208,203,38,8,30,77,35,49,24,25,4
06-07-2023,Discovery,3,393,112,314,278,36,99,59,14,4,10,1
06-07-2023,PrimeSeven,1,146,96,32,16,16,64,55,2,0,2,0
06-07-2023,Aurora,2,376,110,103,83,20,88,60,70,13,57,8
06-07-2023,BitterLaser,2,946,332,379,259,120,86,12,79,34,45,2
06-07-2023,GrayPanthers,3,348,208,184,88,96,88,35,76,30,46,6
06-07-2023,Mustangs,2,365,140,9,5,4,95,81,82,53,29,2
06-07-2023,Quicksilver,3,258,203,209,136,73,56,6,48,4,44,0
06-07-2023,Honeycomb,2,618,66,154,28,126,91,7,31,4,27,2
06-07-2023,GrayPanthers,1,274,71,21,8,13,95,92,37,29,8,0
06-07-2023,Mustangs,3,947,758,25,9,16,68,33,7,6,1,0
06-07-2023,BitterLaser,3,552,1,94,47,47,84,48,33,22,11,0
06-07-2023,Honeycomb,2,476,255,284,192,92,68,58,23,3,20,1
06-07-2023,Quicksilver,3,789,535,744,412,332,70,15,13,7,6,0
06-07-2023,Honeycomb,3,840,471,714,588,126,66,48,17,15,2,0
06-07-2023,Mustangs,1,584,295,579,427,152,60,22,24,22,2,1
06-07-2023,Quicksilver,1,627,286,547,31,516,67,18,35,29,6,1
06-08-2021,BitterLaser,1,733,494,275,134,141,70,67,52,11,41,1
06-08-2021,ImpactTraining,2,572,33,218,0,218,86,1,72,3,69,6
06-08-2021,CelestialInterface,2,507,255,379,98,281,85,62,49,23,26,6
06-08-2021,CelestialInterface,2,363,79,294,167,127,87,85,65,61,4,5
06-08-2021,ImpactTraining,2,674,626,460,228,232,69,37,20,12,8,1
06-08-2021,CelestialInterface,2,782,575,319,86,233,55,9,52,45,7,6
06-08-2021,Discovery,3,457,344,240,221,19,78,18,72,36,36,0
06-08-2021,Aurora,3,137,136,39,32,7,91,28,1,0,1,0
06-08-2021,GrayPanthers,3,567,101,2,0,2,83,65,76,56,20,6
06-08-2021,Aurora,2,292,219,213,100,113,72,13,9,1,8,0
06-08-2021,Aurora,1,518,433,291,24,267,86,79,48,5,43,1
06-08-2021,PrimeSeven,3,233,221,17,7,10,60,17,3,0,3,0
06-08-2022,Aurora,1,459,284,448,83,365,91,41,23,22,1,0
06-08-2022,PrimeSeven,3,242,200,48,24,24,52,23,2,1,1,0
06-08-2022,ImpactTraining,1,143,59,32,29,3,77,42,64,2,62,7
06-08-2022,GrayPanthers,3,707,121,695,19,676,89,1,70,55,15,1
06-08-2022,PrimeSeven,1,298,290,201,66,135,86,21,27,4,23,1
06-08-2022,Mustangs,3,428,161,223,218,5,59,58,33,16,17,2
06-08-2022,CelestialInterface,3,901,470,443,292,151,54,31,51,12,39,2
06-08-2022,Mustangs,3,200,47,171,41,130,75,41,49,2,47,1
06-08-2022,Quicksilver,2,134,113,26,0,26,78,48,19,5,14,1
06-08-2022,GrayPanthers,2,248,190,242,5,237,97,59,88,86,2,5
06-08-2022,CelestialInterface,3,939,465,11,2,9,73,30,67,1,66,2
06-08-2022,CelestialInterface,2,387,264,296,42,254,53,36,11,6,5,0
06-08-2022,GrayPanthers,1,971,542,461,427,34,91,71,90,32,58,9
06-08-2022,Aurora,1,288,275,258,221,37,80,8,39,23,16,3
06-08-2022,Quicksilver,1,743,725,617,159,458,52,37,48,10,38,4
06-08-2022,GrayPanthers,3,116,32,9,3,6,96,56,38,23,15,0
06-08-2022,BitterLaser,2,797,257,22,21,1,52,21,28,9,19,2
06-08-2022,BitterLaser,3,499,262,335,279,56,82,23,66,54,12,4
06-08-2023,Mustangs,1,226,146,170,65,105,55,9,7,0,7,0
06-08-2023,GrayPanthers,2,743,173,572,239,333,64,53,33,26,7,3
06-08-2023,Quicksilver,3,111,40,87,80,7,59,5,34,4,30,2
06-08-2023,Honeycomb,3,541,483,315,7,308,63,58,18,15,3,1
06-08-2023,PrimeSeven,1,464,75,142,73,69,80,2,59,29,30,3
06-08-2023,GrayPanthers,2,550,124,380,49,331,83,68,56,15,41,0
06-08-2023,Mustangs,1,481,106,314,86,228,82,10,68,64,4,5
06-08-2023,BitterLaser,1,694,300,27,14,13,70,7,44,35,9,4
06-09-2021,BitterLaser,2,388,83,58,19,39,57,50,18,2,16,0
06-09-2021,GrayPanthers,3,473,99,312,245,67,62,31,21,13,8,0
06-09-2021,BitterLaser,1,974,174,477,455,22,73,8,15,5,10,0
06-09-2021,Aurora,1,595,143,260,212,48,91,14,75,63,12,1
06-09-2021,Mustangs,3,347,182,117,114,3,67,10,3,1,2,0
06-09-2021,Aurora,1,486,19,262,259,3,67,23,44,22,22,1
06-09-2021,Honeycomb,3,900,282,9,5,4,83,42,9,6,3,0
06-09-2021,Aurora,3,865,151,694,674,20,77,58,19,14,5,0
06-09-2021,PrimeSeven,1,130,60,77,9,68,55,28,18,0,18,0
06-09-2021,Honeycomb,3,480,4,329,138,191,52,43,50,47,3,0
06-09-2021,Mustangs,3,101,12,90,39,51,53,8,43,24,19,2
06-09-2021,BitterLaser,1,523,488,272,271,1,56,4,13,7,6,0
06-09-2022,Mustangs,3,861,145,770,255,515,82,20,79,12,67,6
06-09-2022,Quicksilver,3,699,588,471,310,161,54,46,28,2,26,3
06-09-2022,ImpactTraining,2,746,395,555,83,472,63,1,24,8,16,2
06-09-2022,BitterLaser,2,821,725,781,151,630,63,47,40,23,17,1
06-09-2022,Honeycomb,1,220,149,138,135,3,65,13,9,7,2,0
06-09-2022,Quicksilver,1,725,284,235,182,53,94,3,79,72,7,10
06-09-2022,BitterLaser,1,168,36,163,111,52,90,24,37,0,37,4
06-09-2022,Quicksilver,3,369,244,355,42,313,70,37,1,0,1,0
06-09-2022,ImpactTraining,1,122,60,34,19,15,59,37,46,12,34,5
06-09-2022,GrayPanthers,2,492,20,416,70,346,56,26,12,3,9,0
06-09-2023,ImpactTraining,1,806,538,726,600,126,96,19,32,24,8,1
06-09-2023,Honeycomb,2,163,24,49,32,17,87,84,56,43,13,7
06-09-2023,Quicksilver,3,122,120,90,2,88,59,55,36,8,28,4
06-09-2023,Quicksilver,2,377,301,146,8,138,68,45,48,23,25,5
06-09-2023,BitterLaser,1,620,28,323,125,198,100,50,35,3,32,3
06-09-2023,PrimeSeven,1,638,403,178,44,134,59,1,23,1,22,2
06-09-2023,Mustangs,1,323,84,26,9,17,78,59,28,1,27,3
06-09-2023,BitterLaser,1,272,131,90,79,11,72,50,36,9,27,3
06-10-2021,Honeycomb,3,892,891,671,159,512,68,31,26,12,14,0
06-10-2021,PrimeSeven,1,339,296,128,18,110,83,79,30,20,10,0
06-10-2021,Aurora,2,856,419,341,130,211,90,54,56,46,10,5
06-10-2021,GrayPanthers,2,865,391,788,665,123,90,61,66,55,11,7
06-10-2021,BitterLaser,1,618,525,338,293,45,88,49,16,4,12,1
06-10-2021,GrayPanthers,2,728,145,682,234,448,71,44,33,31,2,3
06-10-2021,ImpactTraining,3,734,616,611,283,328,96,85,20,9,11,0
06-10-2022,Quicksilver,3,169,64,74,49,25,92,18,7,6,1,0
06-10-2022,Aurora,3,728,652,306,47,259,54,12,31,18,13,1
06-10-2022,Aurora,1,897,556,799,28,771,83,48,2,0,2,0
06-10-2022,ImpactTraining,1,824,87,340,92,248,86,54,43,34,9,4
06-10-2022,CelestialInterface,1,800,79,647,80,567,95,53,14,10,4,0
06-10-2022,PrimeSeven,1,814,476,628,359,269,90,25,55,33,22,0
06-10-2022,Honeycomb,2,678,158,519,326,193,94,37,2,0,2,0
06-10-2022,Honeycomb,3,996,224,509,34,475,78,50,22,21,1,2
06-10-2022,PrimeSeven,3,823,242,375,228,147,82,72,72,71,1,9
06-10-2022,Mustangs,1,670,39,3,1,2,82,42,14,3,11,1
06-10-2022,ImpactTraining,3,133,91,127,88,39,79,48,15,2,13,0
06-10-2022,CelestialInterface,3,915,751,704,243,461,73,0,62,21,41,4
06-10-2022,PrimeSeven,1,296,247,88,33,55,53,14,2,0,2,0
06-10-2023,PrimeSeven,3,150,141,79,52,27,66,63,52,1,51,5
06-10-2023,BitterLaser,2,268,221,76,13,63,67,35,1,0,1,0
06-10-2023,Mustangs,2,427,227,160,79,81,66,55,20,6,14,1
06-10-2023,Honeycomb,1,281,198,251,159,92,57,56,32,28,4,3
06-10-2023,CelestialInterface,2,161,38,141,52,89,63,49,30,8,22,0
06-10-2023,BitterLaser,1,474,298,378,80,298,53,27,51,33,18,3
06-10-2023,GrayPanthers,2,377,65,90,31,59,59,0,17,9,8,1
06-10-2023,ImpactTraining,2,468,367,345,108,237,68,58,30,27,3,3
06-10-2023,Aurora,3,359,305,188,113,75,85,25,65,2,63,5
06-10-2023,BitterLaser,1,454,10,63,59,4,80,15,42,16,26,0
06-10-2023,Mustangs,2,810,656,765,285,480,52,8,13,11,2,0
06-10-2023,Discovery,2,794,36,677,244,433,86,6,14,2,12,0
06-11-2021,ImpactTraining,2,997,378,379,31,348,68,23,5,2,3,0
06-11-2021,Discovery,1,839,121,372,341,31,97,51,24,9,15,0
06-11-2021,BitterLaser,2,206,68,136,23,113,54,7,48,37,11,1
06-11-2021,Quicksilver,3,893,730,118,72,46,65,3,11,8,3,0
06-11-2021,Aurora,3,305,118,36,32,4,71,52,60,0,60,0
06-11-2021,GrayPanthers,1,641,198,363,316,47,68,46,52,37,15,2
06-11-2022,Quicksilver,1,781,662,750,463,287,94,87,67,14,53,6
06-11-2022,Quicksilver,1,250,181,192,186,6,60,2,49,17,32,6
06-11-2022,Quicksilver,1,247,223,91,34,57,51,11,47,1,46,0
06-11-2022,Quicksilver,3,280,171,147,38,109,92,65,70,65,5,2
06-11-2022,CelestialInterface,2,473,206,332,237,95,82,42,71,40,31,6
06-11-2023,ImpactTraining,1,537,402,389,249,140,58,9,28,3,25,1
06-11-2023,Mustangs,1,573,471,89,44,45,53,11,25,2,23,0
06-11-2023,BitterLaser,1,712,603,107,9,98,79,49,55,38,17,7
06-11-2023,Mustangs,1,514,307,104,27,77,75,73,50,35,15,4
06-11-2023,Mustangs,3,104,75,55,40,15,70,54,19,6,13,1
06-11-2023,BitterLaser,3,765,720,722,157,565,72,19,37,21,16,3
06-11-2023,Honeycomb,3,740,605,317,129,188,70,54,16,5,11,1
06-11-2023,Quicksilver,2,298,78,169,23,146,57,20,1,0,1,0
06-11-2023,Discovery,3,695,251,583,133,450,98,2,44,6,38,3
06-11-2023,Aurora,1,384,142,364,68,296,57,42,8,3,5,0
06-11-2023,Honeycomb,3,243,9,139,82,57,94,26,56,55,1,3
06-11-2023,CelestialInterface,2,168,127,124,25,99,70,51,59,52,7,0
06-12-2021,CelestialInterface,1,802,21,541,523,18,80,46,76,30,46,8
06-12-2021,Mustangs,3,213,160,61,18,43,85,82,13,3,10,0
06-12-2021,CelestialInterface,1,685,529,458,378,80,61,15,3,0,3,0
06-12-2021,GrayPanthers,3,214,171,203,40,163,83,19,79,50,29,2
06-12-2021,BitterLaser,3,630,177,573,396,177,61,6,51,29,22,2
06-12-2021,GrayPanthers,2,169,24,155,14,141,70,25,14,12,2,0
06-12-2021,Honeycomb,3,942,286,90,22,68,99,11,17,6,11,0
06-12-2021,GrayPanthers,2,545,370,180,148,32,58,48,25,24,1,2
06-12-2021,Honeycomb,3,479,142,342,95,247,99,52,51,12,39,5
06-12-2021,Discovery,1,890,361,20,19,1,86,79,70,42,28,9
06-12-2022,Aurora,2,313,39,156,30,126,100,44,29,1,28,1
06-12-2022,Discovery,2,995,302,454,262,192,96,71,90,39,51,10
06-12-2022,PrimeSeven,3,443,282,300,43,257,83,68,73,63,10,1
06-12-2022,Quicksilver,2,920,870,62,12,50,54,0,16,12,4,1
06-12-2022,Mustangs,2,949,499,33,19,14,91,44,6,0,6,0
06-12-2022,Mustangs,3,792,20,188,2,186,72,45,42,14,28,0
06-12-2022,Aurora,2,881,491,601,573,28,51,5,47,11,36,1
06-12-2023,Mustangs,3,359,104,38,25,13,82,9,31,7,24,1
06-12-2023,PrimeSeven,3,436,29,422,190,232,79,74,62,25,37,5
06-12-2023,ImpactTraining,1,259,213,44,27,17,69,35,35,28,7,1
06-12-2023,Aurora,2,376,162,329,200,129,60,33,27,17,10,0
06-12-2023,ImpactTraining,3,760,381,684,82,602,80,53,4,0,4,0
06-12-2023,BitterLaser,3,961,210,904,805,99,77,18,3,2,1,0
06-12-2023,CelestialInterface,2,797,684,481,108,373,71,1,70,53,17,9
06-12-2023,PrimeSeven,2,817,706,515,58,457,66,25,12,9,3,0
06-12-2023,ImpactTraining,2,233,71,92,4,88,57,34,31,24,7,2
07-01-2021,Discovery,3,229,109,85,2,83,72,2,70,56,14,4
07-01-2021,PrimeSeven,2,329,187,17,10,7,72,56,69,0,69,9
07-01-2021,Quicksilver,1,505,503,256,204,52,98,45,2,1,1,0
07-01-2021,Honeycomb,3,230,6,116,29,87,92,6,16,12,4,1
07-01-2021,Mustangs,3,736,572,735,260,475,52,41,45,17,28,0
07-01-2021,Quicksilver,1,328,207,115,107,8,87,64,33,23,10,3
07-01-2021,PrimeSeven,2,199,81,73,12,61,63,20,5,1,4,0
07-01-2021,Honeycomb,3,819,214,240,221,19,87,14,41,25,16,3
07-01-2021,Honeycomb,1,219,51,208,115,93,56,19,48,35,13,2
07-01-2022,CelestialInterface,2,764,730,620,485,135,95,32,4,0,4,0
07-01-2022,GrayPanthers,3,487,469,196,152,44,89,14,33,10,23,1
07-01-2022,Aurora,2,801,618,284,182,102,52,43,11,4,7,0
07-01-2022,Mustangs,2,231,75,13,4,9,55,1,44,23,21,5
07-01-2022,Quicksilver,1,914,583,722,517,205,87,52,22,13,9,1
07-01-2022,ImpactTraining,1,162,97,71,43,28,53,42,9,6,3,0
07-01-2022,PrimeSeven,1,138,34,44,12,32,98,72,83,49,34,11
07-01-2022,Quicksilver,2,199,142,95,55,40,88,62,32,27,5,3
07-01-2023,Discovery,3,832,291,831,496,335,86,52,20,15,5,0
07-01-2023,CelestialInterface,1,307,120,302,225,77,93,71,34,5,29,3
07-01-2023,CelestialInterface,1,756,493,351,315,36,83,51,0,0,0,0
07-01-2023,ImpactTraining,2,440,232,208,174,34,61,23,52,33,19,2
07-01-2023,Honeycomb,3,848,739,434,398,36,93,54,15,13,2,0
07-01-2023,Aurora,1,151,118,23,6,17,93,68,0,0,0,0
07-01-2023,Aurora,2,886,120,374,73,301,68,38,12,7,5,0
07-01-2023,Quicksilver,1,584,159,563,246,317,65,13,39,20,19,0
07-02-2021,Aurora,2,261,172,176,169,7,52,36,51,42,9,1
07-02-2021,Quicksilver,2,348,85,221,158,63,80,10,25,20,5,0
07-02-2021,Mustangs,1,389,170,15,5,10,74,45,2,1,1,0
07-02-2021,Quicksilver,3,164,150,72,52,20,98,25,34,16,18,4
07-02-2021,Discovery,2,407,317,101,62,39,51,46,39,16,23,4
07-02-2021,Honeycomb,3,896,151,22,2,20,93,78,62,40,22,1
07-02-2021,CelestialInterface,2,726,263,92,32,60,59,6,10,6,4,0
07-02-2021,BitterLaser,2,564,136,417,217,200,57,33,11,3,8,0
07-02-2021,PrimeSeven,2,423,61,183,7,176,58,11,57,21,36,5
07-02-2021,CelestialInterface,3,668,432,603,234,369,51,19,41,1,40,0
07-02-2021,GrayPanthers,1,292,42,172,97,75,80,32,25,12,13,1
07-02-2021,Mustangs,2,155,102,120,23,97,99,34,58,35,23,6
07-02-2021,PrimeSeven,3,921,586,83,32,51,70,2,40,9,31,0
07-02-2021,BitterLaser,1,925,440,390,200,190,67,62,53,40,13,1
07-02-2021,Quicksilver,2,557,37,256,114,142,64,52,22,4,18,0
07-02-2021,ImpactTraining,3,282,29,220,51,169,82,78,13,4,9,0
07-02-2022,Discovery,3,806,437,765,378,387,60,24,23,9,14,1
07-02-2022,ImpactTraining,3,906,832,757,149,608,95,61,24,22,2,0
07-02-2022,BitterLaser,1,187,29,88,73,15,51,32,11,5,6,0
07-02-2022,Aurora,2,255,225,253,220,33,51,23,19,8,11,0
07-02-2022,Mustangs,3,448,224,0,0,0,54,41,11,7,4,0
07-02-2023,ImpactTraining,3,875,552,651,157,494,88,85,4,3,1,0
07-02-2023,PrimeSeven,3,666,108,6,4,2,77,10,5,2,3,0
07-02-2023,ImpactTraining,2,317,137,168,42,126,70,54,42,28,14,0
07-02-2023,Mustangs,2,230,149,204,140,64,68,55,7,2,5,0
07-02-2023,Quicksilver,2,510,352,467,413,54,53,44,10,7,3,0
07-02-2023,Aurora,3,966,753,890,19,871,76,21,14,3,11,0
07-02-2023,Quicksilver,1,860,121,703,275,428,97,86,44,8,36,2
07-02-2023,Honeycomb,3,650,615,397,128,269,50,34,5,2,3,0
07-02-2023,BitterLaser,3,285,114,249,68,181,66,48,18,6,12,0
07-02-2023,CelestialInterface,1,479,285,168,91,77,73,20,10,7,3,0
07-03-2021,GrayPanthers,3,135,69,63,18,45,81,79,55,50,5,0
07-03-2021,BitterLaser,3,232,55,97,1,96,82,13,48,45,3,5
07-03-2021,BitterLaser,3,462,131,218,171,47,62,3,61,4,57,2
07-03-2021,PrimeSeven,2,658,18,446,405,41,83,51,35,29,6,0
07-03-2021,Discovery,2,135,77,32,7,25,70,15,13,9,4,0
07-03-2021,CelestialInterface,3,718,669,63,2,61,50,43,42,10,32,3
07-03-2021,ImpactTraining,2,452,217,324,103,221,71,51,41,34,7,0
07-03-2021,PrimeSeven,3,573,94,224,31,193,83,11,62,32,30,8
07-03-2021,PrimeSeven,2,408,258,64,7,57,83,32,31,22,9,1
07-03-2021,ImpactTraining,3,851,164,139,79,60,83,8,54,20,34,3
07-03-2021,CelestialInterface,1,153,86,93,13,80,86,34,21,6,15,1
07-03-2022,Aurora,3,212,161,165,64,101,86,72,31,9,22,2
07-03-2022,Quicksilver,3,244,117,201,64,137,98,83,51,12,39,1
07-03-2022,GrayPanthers,1,721,291,288,70,218,62,55,59,2,57,0
07-03-2022,ImpactTraining,2,217,119,36,35,1,84,65,43,32,11,0
07-03-2022,Aurora,1,309,228,66,26,40,75,70,22,7,15,1
07-03-2022,Mustangs,2,234,146,140,31,109,50,23,38,28,10,3
07-03-2022,Mustangs,1,567,16,246,13,233,77,67,10,9,1,0
07-03-2023,CelestialInterface,3,794,103,322,290,32,91,13,61,32,29,4
07-03-2023,ImpactTraining,3,413,228,357,49,308,93,60,14,5,9,0
07-03-2023,Aurora,1,346,242,59,22,37,81,32,63,57,6,4
07-03-2023,Aurora,2,858,380,789,286,503,58,4,6,0,6,0
07-03-2023,Aurora,1,694,233,386,39,347,94,36,52,26,26,2
07-03-2023,PrimeSeven,2,126,14,3,1,2,96,89,95,25,70,6
07-03-2023,GrayPanthers,2,511,478,134,99,35,64,7,17,8,9,0
07-03-2023,Mustangs,3,566,177,99,75,24,65,54,43,8,35,2
07-04-2021,Mustangs,3,459,315,3,1,2,57,55,9,1,8,0
07-04-2021,PrimeSeven,2,215,34,127,41,86,60,31,23,22,1,2
07-04-2021,Discovery,3,284,191,119,59,60,86,35,79,70,9,9
07-04-2021,BitterLaser,2,673,261,592,54,538,81,51,57,42,15,2
07-04-2021,Aurora,2,226,84,76,6,70,72,68,66,12,54,8
07-04-2021,ImpactTraining,1,156,132,23,9,14,72,60,29,9,20,3
07-04-2021,Quicksilver,2,292,176,277,212,65,60,56,33,8,25,1
07-04-2021,Mustangs,3,180,174,96,19,77,72,16,47,18,29,4
07-04-2021,Aurora,2,462,74,449,244,205,100,44,38,34,4,3
07-04-2021,CelestialInterface,3,892,773,645,208,437,63,32,0,0,0,0
07-04-2022,PrimeSeven,1,780,732,407,195,212,89,31,64,42,22,0
07-04-2022,GrayPanthers,1,325,202,24,9,15,95,51,31,16,15,0
07-04-2022,CelestialInterface,3,521,31,480,356,124,93,91,42,1,41,2
07-04-2022,Honeycomb,2,187,146,71,7,64,55,44,48,27,21,5
07-04-2022,Honeycomb,1,390,135,69,51,18,63,61,48,41,7,3
07-04-2022,GrayPanthers,1,317,242,1,0,1,60,45,52,24,28,5
07-04-2022,Honeycomb,2,863,824,571,539,32,98,79,32,13,19,3
07-04-2023,BitterLaser,3,803,604,316,90,226,50,38,39,1,38,2
07-04-2023,Aurora,1,653,519,403,273,130,90,64,5,3,2,0
07-04-2023,Honeycomb,1,922,104,302,25,277,62,12,34,14,20,1
07-04-2023,GrayPanthers,2,154,148,129,6,123,71,12,34,1,33,3
07-04-2023,Mustangs,2,847,592,194,159,35,83,42,59,51,8,2
07-04-2023,GrayPanthers,1,208,75,147,124,23,54,18,14,6,8,0
07-04-2023,BitterLaser,2,777,702,47,15,32,52,42,42,31,11,3
07-04-2023,CelestialInterface,2,944,638,835,128,707,98,65,37,7,30,3
07-04-2023,PrimeSeven,1,802,366,435,72,363,54,0,33,10,23,2
07-04-2023,GrayPanthers,3,615,114,299,132,167,76,2,21,1,20,0
07-04-2023,BitterLaser,2,903,85,724,495,229,96,0,78,28,50,4
07-04-2023,GrayPanthers,3,472,14,238,5,233,98,47,28,21,7,0
07-04-2023,Discovery,1,753,445,747,508,239,88,84,70,15,55,4
07-05-2021,GrayPanthers,2,644,643,316,65,251,83,52,65,61,4,7
07-05-2021,PrimeSeven,1,482,3,159,84,75,57,31,34,31,3,0
07-05-2021,GrayPanthers,2,141,32,117,8,109,83,15,50,34,16,3
07-05-2021,Aurora,1,470,265,101,26,75,89,70,10,1,9,0
07-05-2021,Discovery,1,200,164,142,114,28,80,38,18,3,15,0
07-05-2021,ImpactTraining,1,987,637,201,74,127,89,44,77,19,58,5
07-05-2021,PrimeSeven,1,899,142,305,204,101,58,15,29,19,10,2
07-05-2021,CelestialInterface,1,335,313,230,74,156,86,9,28,19,9,1
07-05-2021,BitterLaser,1,275,160,128,100,28,54,32,42,3,39,2
07-05-2021,Quicksilver,2,207,158,148,94,54,83,11,21,18,3,2
07-05-2021,CelestialInterface,3,928,67,360,298,62,61,21,54,32,22,7
07-05-2022,GrayPanthers,2,785,571,42,21,21,52,5,11,8,3,0
07-05-2022,CelestialInterface,1,321,108,35,34,1,79,67,72,13,59,1
07-05-2022,Honeycomb,3,388,119,89,78,11,72,47,67,41,26,0
07-05-2022,Aurora,2,116,101,74,13,61,76,7,19,18,1,0
07-05-2022,Honeycomb,1,727,71,625,275,350,74,40,32,27,5,2
07-05-2022,Honeycomb,1,242,239,11,3,8,80,44,43,32,11,2
07-05-2022,Mustangs,3,682,170,441,108,333,84,55,45,31,14,3
07-05-2023,PrimeSeven,2,218,90,85,54,31,50,41,45,42,3,1
07-05-2023,BitterLaser,1,948,408,607,285,322,74,8,4,2,2,0
07-05-2023,Mustangs,1,381,197,272,39,233,100,67,63,53,10,8
07-05-2023,BitterLaser,2,839,291,588,385,203,72,36,71,3,68,7
07-05-2023,Honeycomb,3,184,62,138,86,52,75,51,48,37,11,1
07-05-2023,Quicksilver,1,448,6,90,26,64,100,82,18,1,17,0
07-06-2021,BitterLaser,1,938,213,538,10,528,70,38,24,21,3,0
07-06-2021,Mustangs,1,205,153,50,41,9,86,77,47,13,34,3
07-06-2021,ImpactTraining,2,925,669,675,168,507,99,49,97,91,6,10
07-06-2021,Mustangs,3,373,228,6,4,2,81,67,28,14,14,0
07-06-2021,Aurora,3,152,30,15,14,1,71,18,30,9,21,1
07-06-2022,Quicksilver,2,270,91,128,56,72,95,27,82,52,30,9
07-06-2022,Mustangs,3,653,136,81,42,39,53,15,28,26,2,1
07-06-2022,BitterLaser,1,715,446,47,9,38,71,56,9,0,9,0
07-06-2022,BitterLaser,1,381,255,318,112,206,76,32,54,6,48,4
07-06-2022,Aurora,2,846,824,319,203,116,70,26,23,19,4,2
07-06-2022,BitterLaser,3,278,210,276,22,254,64,50,45,41,4,1
07-06-2022,GrayPanthers,1,805,205,460,116,344,59,28,46,27,19,3
07-06-2022,CelestialInterface,1,498,477,46,36,10,52,6,21,20,1,0
07-06-2023,CelestialInterface,2,427,207,306,303,3,66,45,0,0,0,0
07-06-2023,PrimeSeven,1,540,169,387,82,305,79,35,6,4,2,0
07-06-2023,Discovery,2,769,280,732,575,157,85,62,45,6,39,5
07-06-2023,Aurora,2,536,510,59,16,43,79,24,2,0,2,0
07-06-2023,ImpactTraining,2,990,293,158,78,80,74,17,50,20,30,0
07-06-2023,ImpactTraining,2,228,22,96,66,30,62,1,50,40,10,2
07-06-2023,Aurora,2,474,427,357,15,342,88,82,12,11,1,0
07-06-2023,Mustangs,1,329,82,103,91,12,84,56,16,14,2,0
07-07-2021,PrimeSeven,3,722,714,491,173,318,88,86,13,7,6,0
07-07-2021,ImpactTraining,3,578,318,91,21,70,77,61,51,9,42,3
07-07-2021,Honeycomb,2,321,117,246,150,96,74,51,24,9,15,1
07-07-2021,Discovery,3,124,44,69,43,26,54,42,35,5,30,3
07-07-2021,BitterLaser,2,219,138,79,62,17,82,81,46,33,13,1
07-07-2021,Quicksilver,2,432,47,246,203,43,68,60,5,1,4,0
07-07-2022,ImpactTraining,1,342,74,238,201,37,97,45,79,37,42,3
07-07-2022,Honeycomb,3,346,70,75,33,42,75,36,15,14,1,1
07-07-2022,GrayPanthers,2,656,633,28,0,28,94,30,39,15,24,2
07-07-2022,PrimeSeven,1,590,510,293,269,24,90,43,53,5,48,6
07-07-2022,Discovery,3,373,58,199,110,89,88,9,53,38,15,2
07-07-2022,Discovery,1,711,188,512,285,227,83,1,41,12,29,0
07-07-2022,Quicksilver,1,398,139,49,32,17,50,36,11,1,10,0
07-07-2022,BitterLaser,1,752,405,1,0,1,79,70,73,0,73,7
07-07-2023,CelestialInterface,2,903,662,332,164,168,56,35,8,5,3,0
07-07-2023,Quicksilver,1,748,608,116,36,80,78,30,24,11,13,0
07-07-2023,Quicksilver,2,618,485,175,120,55,97,74,28,4,24,1
07-07-2023,Discovery,3,530,197,345,2,343,70,34,6,5,1,0
07-07-2023,GrayPanthers,3,543,407,429,375,54,88,67,5,2,3,0
07-07-2023,GrayPanthers,3,187,122,120,64,56,84,28,15,3,12,0
07-07-2023,ImpactTraining,3,112,0,111,108,3,95,60,7,1,6,0
07-08-2021,Mustangs,1,337,114,60,7,53,61,42,13,1,12,0
07-08-2021,BitterLaser,2,175,159,46,18,28,83,3,13,2,11,0
07-08-2021,ImpactTraining,1,913,782,323,36,287,74,38,3,1,2,0
07-08-2021,GrayPanthers,1,731,229,440,382,58,98,34,92,85,7,9
07-08-2021,ImpactTraining,2,218,213,19,15,4,88,61,48,46,2,4
07-08-2021,BitterLaser,2,521,435,24,11,13,52,40,17,8,9,0
07-08-2021,BitterLaser,1,613,496,500,104,396,72,52,3,0,3,0
07-08-2021,Quicksilver,2,613,357,430,147,283,80,70,30,14,16,0
07-08-2022,BitterLaser,2,350,67,206,67,139,84,19,25,3,22,2
07-08-2022,ImpactTraining,2,650,323,530,219,311,93,7,79,46,33,3
07-08-2022,GrayPanthers,1,128,15,94,75,19,99,87,60,32,28,4
07-08-2022,Quicksilver,1,988,252,970,366,604,56,38,10,5,5,0
07-08-2022,Mustangs,1,890,755,695,305,390,60,33,9,5,4,0
07-08-2022,PrimeSeven,2,886,563,790,561,229,89,48,43,18,25,2
07-08-2022,Honeycomb,1,620,524,119,76,43,58,34,9,5,4,0
07-08-2022,Quicksilver,1,569,120,277,182,95,62,25,56,29,27,3
07-08-2022,BitterLaser,3,708,153,47,34,13,62,12,30,10,20,2
07-08-2022,Discovery,3,709,138,431,262,169,95,67,32,21,11,3
07-08-2022,CelestialInterface,2,696,617,246,56,190,85,68,73,52,21,2
07-08-2023,Honeycomb,1,280,33,137,85,52,87,68,82,12,70,8
07-08-2023,BitterLaser,2,616,537,525,269,256,66,26,8,3,5,0
07-08-2023,Quicksilver,3,620,606,189,130,59,96,11,86,35,51,10
07-08-2023,CelestialInterface,2,799,460,161,38,123,68,19,12,4,8,0
07-08-2023,Honeycomb,1,984,788,188,98,90,100,56,28,15,13,3
07-08-2023,Discovery,1,770,7,619,93,526,76,64,5,1,4,0
07-08-2023,Honeycomb,1,693,561,494,68,426,74,2,1,0,1,0
07-08-2023,PrimeSeven,1,240,4,235,28,207,69,21,66,8,58,8
07-08-2023,PrimeSeven,1,465,8,267,158,109,68,67,25,22,3,1
07-08-2023,PrimeSeven,3,466,50,230,116,114,58,6,10,8,2,0
07-08-2023,PrimeSeven,2,852,438,850,811,39,74,52,41,2,39,3
07-08-2023,GrayPanthers,2,772,416,427,1,426,60,15,35,11,24,0
07-08-2023,Discovery,1,666,563,198,90,108,85,48,41,12,29,5
07-09-2021,CelestialInterface,3,381,262,52,24,28,93,42,30,10,20,0
07-09-2021,Discovery,3,531,42,473,119,354,96,14,65,61,4,7
07-09-2021,Discovery,1,416,66,35,18,17,60,44,17,0,17,0
07-09-2021,BitterLaser,1,383,266,103,99,4,51,11,18,16,2,0
07-09-2021,Discovery,2,808,509,129,23,106,93,51,87,83,4,4
07-09-2021,PrimeSeven,2,973,226,541,61,480,93,50,88,49,39,11
07-09-2021,GrayPanthers,1,190,71,78,13,65,85,14,13,1,12,0
07-09-2021,Aurora,2,531,34,210,151,59,53,1,49,36,13,0
07-09-2021,Quicksilver,2,430,157,250,194,56,70,40,57,17,40,1
07-09-2021,BitterLaser,1,908,739,696,251,445,99,66,90,24,66,6
07-09-2021,CelestialInterface,3,539,309,510,68,442,50,44,8,2,6,0
07-09-2021,Honeycomb,1,569,399,44,42,2,94,3,16,10,6,0
07-09-2022,Aurora,1,858,473,58,45,13,99,41,27,24,3,2
07-09-2022,BitterLaser,1,536,185,417,351,66,97,44,81,1,80,10
07-09-2022,Discovery,1,170,116,66,16,50,88,40,80,8,72,2
07-09-2022,BitterLaser,1,900,8,846,6,840,79,9,72,30,42,5
07-09-2022,BitterLaser,1,495,445,462,314,148,56,45,10,7,3,0
07-09-2022,Quicksilver,1,154,151,87,16,71,86,53,64,0,64,4
07-09-2022,PrimeSeven,3,768,503,744,406,338,78,35,13,5,8,0
07-09-2022,Mustangs,2,222,163,149,11,138,51,45,36,3,33,4
07-09-2022,Quicksilver,1,409,292,401,319,82,90,65,51,11,40,1
07-09-2022,Discovery,3,785,108,162,96,66,79,58,65,33,32,7
07-09-2022,CelestialInterface,1,687,611,445,119,326,58,3,42,38,4,2
07-09-2022,GrayPanthers,2,682,14,142,30,112,82,14,39,35,4,3
07-09-2023,Aurora,1,260,56,188,55,133,72,37,9,2,7,0
07-09-2023,Quicksilver,3,229,186,198,111,87,88,79,62,12,50,6
07-09-2023,Honeycomb,1,675,475,575,363,212,56,44,27,13,14,1
07-09-2023,Honeycomb,1,496,78,180,130,50,87,61,15,2,13,0
07-09-2023,PrimeSeven,1,560,437,416,131,285,51,26,39,12,27,3
07-09-2023,Honeycomb,1,507,71,295,206,89,100,52,40,34,6,3
07-09-2023,Discovery,3,123,16,9,8,1,71,51,29,16,13,3
07-09-2023,Discovery,3,836,676,773,518,255,58,23,13,3,10,0
07-09-2023,Mustangs,1,838,820,209,13,196,57,7,4,3,1,0
07-09-2023,CelestialInterface,2,114,101,32,11,21,73,18,13,7,6,0
07-10-2021,Quicksilver,2,110,6,53,16,37,54,49,9,6,3,0
07-10-2021,CelestialInterface,1,203,166,67,27,40,64,23,35,19,16,2
07-10-2021,Discovery,2,512,0,343,143,200,90,89,36,6,30,1
07-10-2021,Aurora,1,538,145,411,35,376,83,65,56,44,12,4
07-10-2022,Mustangs,3,332,51,297,37,260,60,16,59,0,59,4
07-10-2022,Honeycomb,3,296,68,21,14,7,88,32,22,16,6,2
07-10-2022,PrimeSeven,3,814,634,271,233,38,68,41,12,7,5,0
07-10-2022,ImpactTraining,3,785,341,597,23,574,73,31,44,16,28,1
07-10-2022,GrayPanthers,1,205,149,183,105,78,57,32,47,7,40,4
07-10-2022,Aurora,3,160,96,114,7,107,65,47,63,41,22,1
07-10-2022,GrayPanthers,2,542,291,388,89,299,67,29,35,28,7,2
07-10-2022,ImpactTraining,2,683,340,401,166,235,69,45,41,38,3,3
07-10-2022,Honeycomb,3,656,178,398,271,127,89,10,66,19,47,7
07-10-2023,Honeycomb,3,724,266,321,155,166,53,20,17,12,5,1
07-10-2023,CelestialInterface,2,931,320,721,587,134,85,11,10,3,7,0
07-10-2023,Quicksilver,1,690,21,490,290,200,55,36,36,12,24,1
07-10-2023,CelestialInterface,2,821,284,753,432,321,62,11,54,3,51,3
07-10-2023,BitterLaser,3,791,139,484,187,297,51,23,30,3,27,0
07-10-2023,PrimeSeven,1,697,681,477,273,204,78,3,73,60,13,5
07-10-2023,Aurora,2,476,279,45,21,24,52,46,27,4,23,0
07-10-2023,Mustangs,2,180,101,55,6,49,82,54,69,65,4,6
07-10-2023,GrayPanthers,3,637,64,181,92,89,55,53,54,42,12,5
07-10-2023,GrayPanthers,1,284,242,38,14,24,54,4,27,18,9,2
07-10-2023,PrimeSeven,2,907,807,721,370,351,62,59,17,15,2,1
07-10-2023,BitterLaser,2,941,349,478,176,302,68,49,17,3,14,0
07-10-2023,Quicksilver,2,295,18,104,94,10,75,22,48,14,34,5
07-11-2021,ImpactTraining,3,501,424,396,142,254,93,41,28,13,15,0
07-11-2021,GrayPanthers,3,849,789,419,249,170,50,22,31,11,20,3
07-11-2021,PrimeSeven,1,974,124,360,142,218,75,36,15,9,6,0
07-11-2021,GrayPanthers,2,595,260,546,153,393,70,23,58,2,56,7
07-11-2022,Honeycomb,3,471,66,118,105,13,92,70,25,8,17,2
07-11-2022,CelestialInterface,2,224,92,138,18,120,86,13,36,21,15,0
07-11-2022,Honeycomb,2,103,31,57,24,33,81,24,21,8,13,2
07-11-2022,BitterLaser,3,231,184,92,6,86,84,55,17,6,11,0
07-11-2022,Discovery,2,685,509,359,145,214,88,75,26,22,4,1
07-11-2023,CelestialInterface,2,496,386,449,440,9,67,37,37,23,14,4
07-11-2023,BitterLaser,3,764,144,230,166,64,74,10,51,29,22,4
07-11-2023,Aurora,3,625,377,220,126,94,88,17,15,13,2,1
07-11-2023,GrayPanthers,1,697,220,409,397,12,81,79,62,54,8,7
07-11-2023,Aurora,1,760,538,240,129,111,95,65,84,52,32,8
07-11-2023,Mustangs,2,736,704,325,142,183,72,40,4,3,1,0
07-11-2023,Quicksilver,3,465,162,375,41,334,54,25,44,32,12,2
07-11-2023,Quicksilver,3,498,251,267,64,203,67,48,55,0,55,1
07-11-2023,GrayPanthers,1,786,547,186,132,54,81,35,77,61,16,0
07-11-2023,Discovery,1,982,589,812,494,318,77,73,6,4,2,0
07-11-2023,PrimeSeven,3,869,640,647,414,233,83,72,34,18,16,3
07-12-2021,ImpactTraining,2,921,680,760,130,630,58,51,15,13,2,0
07-12-2021,PrimeSeven,2,835,468,234,138,96,78,55,8,2,6,0
07-12-2021,Mustangs,3,735,22,452,296,156,83,56,16,13,3,0
07-12-2021,Aurora,3,371,41,129,46,83,85,73,49,18,31,5
07-12-2021,BitterLaser,3,713,85,632,98,534,100,25,94,24,70,5
07-12-2021,ImpactTraining,2,561,302,220,44,176,60,30,12,1,11,0
07-12-2021,Discovery,2,586,256,298,196,102,57,15,25,23,2,2
07-12-2022,Discovery,3,824,587,493,156,337,92,6,69,58,11,0
07-12-2022,CelestialInterface,3,230,81,79,16,63,98,16,76,31,45,2
07-12-2022,Honeycomb,2,104,18,96,17,79,93,16,41,34,7,1
07-12-2022,CelestialInterface,2,781,410,239,55,184,100,13,12,5,7,0
07-12-2022,Discovery,1,686,414,178,56,122,84,16,71,21,50,3
07-12-2022,ImpactTraining,2,666,647,248,178,70,87,83,25,22,3,0
07-12-2022,PrimeSeven,3,275,212,244,100,144,76,24,7,2,5,0
07-12-2022,CelestialInterface,3,783,157,115,3,112,100,51,21,20,1,1
07-12-2022,Mustangs,3,220,188,148,105,43,80,78,55,11,44,1
07-12-2022,Quicksilver,3,690,590,383,242,141,94,83,38,37,1,4
07-12-2022,Discovery,3,600,289,453,31,422,89,29,51,13,38,4
07-12-2023,GrayPanthers,1,136,62,127,94,33,87,8,75,55,20,2
07-12-2023,Quicksilver,1,829,737,216,32,184,72,67,28,17,11,0
07-12-2023,CelestialInterface,2,373,347,299,243,56,92,89,65,59,6,2
07-12-2023,ImpactTraining,3,238,203,92,15,77,69,55,44,19,25,3
07-12-2023,Quicksilver,3,768,418,44,28,16,100,83,61,16,45,1
07-12-2023,PrimeSeven,2,163,100,59,46,13,77,23,5,1,4,0
07-12-2023,Discovery,3,914,808,63,47,16,59,29,54,35,19,6
07-12-2023,GrayPanthers,3,870,443,111,18,93,87,37,49,43,6,0
07-12-2023,PrimeSeven,1,786,756,345,43,302,94,67,83,39,44,6
08-01-2021,Mustangs,3,296,143,148,38,110,88,37,64,38,26,2
08-01-2021,Aurora,1,751,374,200,101,99,75,8,22,6,16,2
08-01-2021,Honeycomb,1,227,59,196,117,79,83,10,74,40,34,4
08-01-2021,Discovery,3,740,194,457,355,102,88,78,73,39,34,2
08-01-2021,Quicksilver,2,541,318,37,20,17,81,57,43,11,32,1
08-01-2021,Mustangs,2,110,86,74,37,37,92,88,34,15,19,1
08-01-2021,Discovery,1,690,58,77,55,22,56,40,11,10,1,0
08-01-2021,GrayPanthers,3,594,405,485,356,129,99,0,30,20,10,2
08-01-2021,ImpactTraining,1,770,455,545,214,331,61,4,51,33,18,1
08-01-2021,CelestialInterface,2,910,343,777,292,485,88,55,3,0,3,0
08-01-2021,Discovery,2,302,182,193,91,102,89,33,84,55,29,8
08-01-2021,Aurora,3,365,102,218,155,63,82,78,14,9,5,0
08-01-2021,Mustangs,2,861,201,402,84,318,60,55,31,7,24,3
08-01-2022,PrimeSeven,2,261,188,180,106,74,62,61,59,23,36,1
08-01-2022,Aurora,3,283,91,68,32,36,72,49,66,47,19,3
08-01-2022,GrayPanthers,3,905,527,178,149,29,60,26,38,8,30,3
08-01-2022,Aurora,3,687,595,520,107,413,51,24,25,17,8,2
08-01-2022,BitterLaser,1,164,19,18,5,13,80,40,0,0,0,0
08-01-2022,BitterLaser,2,534,519,48,37,11,99,95,6,5,1,0
08-01-2022,ImpactTraining,3,317,177,149,60,89,82,44,37,21,16,4
08-01-2022,BitterLaser,2,187,23,99,1,98,83,6,44,21,23,4
08-01-2022,PrimeSeven,1,913,663,600,302,298,98,10,21,0,21,1
08-01-2022,Honeycomb,1,385,100,280,219,61,53,40,29,22,7,0
08-01-2023,BitterLaser,3,231,144,207,200,7,92,75,25,2,23,2
08-01-2023,Discovery,3,252,84,134,121,13,91,19,44,29,15,5
08-01-2023,BitterLaser,1,921,687,244,234,10,75,54,32,27,5,3
08-01-2023,Honeycomb,3,469,137,437,335,102,87,77,3,0,3,0
08-01-2023,Aurora,1,316,126,149,132,17,99,62,47,11,36,6
08-01-2023,CelestialInterface,1,830,687,12,6,6,94,16,83,57,26,10
08-01-2023,Honeycomb,3,824,651,282,281,1,62,24,47,24,23,3
08-01-2023,Mustangs,1,139,96,73,32,41,80,50,69,6,63,1
08-01-2023,Mustangs,2,855,533,597,520,77,72,35,49,0,49,6
08-01-2023,Discovery,2,544,202,334,208,126,72,0,17,8,9,0
08-01-2023,GrayPanthers,2,386,381,124,119,5,96,41,30,21,9,0
08-01-2023,Honeycomb,3,188,102,32,16,16,51,38,15,3,12,1
08-02-2021,CelestialInterface,1,159,57,28,22,6,84,51,11,5,6,0
08-02-2021,ImpactTraining,3,819,724,580,449,131,96,82,88,55,33,1
08-02-2021,Discovery,3,687,171,183,166,17,85,80,5,2,3,0
08-02-2021,Mustangs,2,629,64,234,146,88,54,2,49,28,21,6
08-02-2021,Honeycomb,2,959,458,393,274,119,81,69,38,20,18,0
08-02-2021,Honeycomb,1,557,225,392,313,79,60,41,56,48,8,0
08-02-2021,PrimeSeven,1,213,186,68,55,13,61,3,45,9,36,3
08-02-2021,Mustangs,2,775,531,103,64,39,100,72,22,11,11,1
08-02-2022,ImpactTraining,1,119,75,107,13,94,65,36,52,38,14,6
08-02-2022,Discovery,3,752,483,471,263,208,78,53,75,10,65,7
08-02-2022,BitterLaser,2,977,828,656,272,384,81,24,13,10,3,0
08-02-2022,Discovery,3,694,55,551,123,428,73,62,14,5,9,1
08-02-2022,Aurora,3,410,301,379,53,326,57,0,0,0,0,0
08-02-2022,Quicksilver,2,776,750,608,585,23,93,0,88,85,3,5
08-02-2022,Discovery,3,921,73,131,0,131,68,11,7,0,7,0
08-02-2022,GrayPanthers,1,398,350,210,29,181,68,37,53,38,15,6
08-02-2022,Mustangs,3,225,167,38,7,31,51,46,36,13,23,3
08-02-2022,CelestialInterface,2,170,107,64,36,28,58,29,31,16,15,2
08-02-2023,GrayPanthers,3,673,388,304,291,13,59,21,28,26,2,3
08-02-2023,Aurora,2,320,33,76,44,32,90,81,27,20,7,0
08-02-2023,Mustangs,1,577,422,525,117,408,55,30,39,14,25,4
08-02-2023,Honeycomb,1,151,142,63,47,16,64,51,54,6,48,4
08-02-2023,GrayPanthers,2,837,827,478,165,313,70,53,31,5,26,2
08-02-2023,Aurora,1,689,81,531,501,30,80,23,21,10,11,2
08-02-2023,Mustangs,1,111,9,85,27,58,98,32,52,29,23,3
08-02-2023,Mustangs,1,929,836,116,82,34,99,24,12,6,6,0
08-02-2023,BitterLaser,1,917,193,547,17,530,91,50,1,0,1,0
08-02-2023,Aurora,3,241,192,20,4,16,52,24,35,6,29,0
08-02-2023,PrimeSeven,1,387,115,150,103,47,75,0,74,13,61,5
08-02-2023,BitterLaser,1,817,662,509,100,409,97,95,15,0,15,1
08-03-2021,Aurora,1,165,129,38,28,10,64,6,41,18,23,4
08-03-2021,PrimeSeven,2,489,401,238,230,8,59,5,16,10,6,1
08-03-2021,PrimeSeven,1,975,146,266,77,189,89,41,88,85,3,6
08-03-2021,Discovery,1,399,294,82,65,17,94,0,60,39,21,0
08-03-2021,Mustangs,3,732,614,418,183,235,72,2,63,21,42,6
08-03-2021,Honeycomb,1,687,40,501,13,488,63,45,48,14,34,2
08-03-2021,ImpactTraining,2,495,79,260,55,205,54,15,43,19,24,1
08-03-2021,Discovery,3,251,76,141,25,116,67,33,27,21,6,3
08-03-2022,ImpactTraining,3,812,90,193,94,99,76,41,45,36,9,3
08-03-2022,Quicksilver,1,290,171,110,73,37,84,4,38,14,24,3
08-03-2022,Mustangs,2,116,7,46,15,31,89,80,59,52,7,4
08-03-2022,Discovery,1,621,511,165,49,116,90,79,84,30,54,0
08-03-2022,GrayPanthers,1,434,59,195,24,171,87,50,36,26,10,2
08-03-2022,Aurora,2,217,167,62,50,12,52,39,26,10,16,0
08-03-2022,Discovery,2,704,269,340,81,259,76,26,42,30,12,0
08-03-2023,GrayPanthers,1,513,504,295,147,148,77,67,17,10,7,0
08-03-2023,CelestialInterface,2,676,183,203,39,164,81,41,37,34,3,1
08-03-2023,CelestialInterface,2,521,31,372,214,158,91,77,46,34,12,5
08-03-2023,Aurora,3,212,57,154,99,55,75,44,34,0,34,2
08-03-2023,Aurora,2,333,268,283,156,127,75,68,25,21,4,2
08-03-2023,Discovery,2,831,701,446,327,119,50,2,37,4,33,3
08-03-2023,Discovery,1,566,129,229,1,228,82,55,63,10,53,6
08-03-2023,CelestialInterface,2,478,10,116,1,115,66,0,52,48,4,4
08-03-2023,Quicksilver,3,310,96,95,18,77,91,14,69,54,15,0
08-03-2023,Aurora,1,954,341,228,184,44,59,45,34,15,19,2
08-03-2023,BitterLaser,2,435,287,274,62,212,64,62,44,11,33,1
08-04-2021,GrayPanthers,2,306,154,120,48,72,81,57,12,9,3,0
08-04-2021,BitterLaser,1,555,263,236,31,205,85,79,82,71,11,3
08-04-2021,Quicksilver,1,906,688,432,21,411,56,1,52,10,42,3
08-04-2021,PrimeSeven,2,890,282,447,366,81,90,49,34,29,5,4
08-04-2021,Aurora,2,537,465,57,1,56,79,2,36,0,36,4
08-04-2021,Honeycomb,1,117,65,26,17,9,73,45,54,26,28,1
08-04-2021,Mustangs,2,707,517,466,411,55,88,39,59,55,4,2
08-04-2021,Aurora,3,502,154,425,10,415,74,72,57,13,44,1
08-04-2022,Aurora,1,426,25,297,213,84,100,32,60,24,36,7
08-04-2022,PrimeSeven,2,314,192,183,75,108,50,5,14,2,12,1
08-04-2022,CelestialInterface,3,674,356,381,373,8,96,27,57,46,11,7
08-04-2022,CelestialInterface,2,576,134,115,41,74,91,62,28,14,14,1
08-04-2022,Honeycomb,1,457,392,309,239,70,65,12,26,16,10,0
08-04-2022,Aurora,3,231,73,116,36,80,55,33,0,0,0,0
08-04-2022,Quicksilver,3,634,220,437,131,306,61,13,12,11,1,0
08-04-2022,GrayPanthers,2,120,89,63,28,35,88,35,15,8,7,1
08-04-2022,BitterLaser,2,381,190,82,69,13,62,44,58,42,16,7
08-04-2022,GrayPanthers,3,372,284,367,266,101,97,52,10,9,1,0
08-04-2022,Aurora,1,591,167,295,160,135,83,4,45,28,17,3
08-04-2022,Mustangs,3,911,543,737,638,99,94,23,43,12,31,4
08-04-2022,PrimeSeven,2,422,109,294,45,249,86,10,41,20,21,1
08-04-2023,Mustangs,2,347,15,186,56,130,98,39,16,2,14,0
08-04-2023,CelestialInterface,1,118,75,5,2,3,50,33,7,1,6,0
08-04-2023,ImpactTraining,3,918,560,730,686,44,71,13,52,32,20,0
08-04-2023,GrayPanthers,1,118,9,2,1,1,92,6,73,21,52,1
08-04-2023,Honeycomb,1,641,320,57,12,45,50,47,25,20,5,1
08-04-2023,GrayPanthers,2,334,120,184,176,8,55,28,30,5,25,2
08-04-2023,Discovery,1,915,151,726,408,318,50,32,18,16,2,0
08-04-2023,CelestialInterface,3,677,592,167,162,5,54,28,1,0,1,0
08-04-2023,Honeycomb,3,265,209,44,38,6,82,48,43,0,43,2
08-04-2023,CelestialInterface,3,451,386,163,80,83,99,72,35,28,7,2
08-05-2021,ImpactTraining,1,960,769,359,311,48,92,79,39,36,3,3
08-05-2021,GrayPanthers,1,424,47,46,27,19,71,9,35,2,33,1
08-05-2021,Aurora,1,259,60,56,46,10,76,66,28,17,11,0
08-05-2021,GrayPanthers,1,636,429,551,454,97,57,20,32,13,19,0
08-05-2021,BitterLaser,2,882,657,870,502,368,81,51,64,10,54,6
08-05-2021,Honeycomb,1,226,74,203,184,19,53,47,28,26,2,3
08-05-2021,Mustangs,2,703,543,614,230,384,61,54,17,15,2,1
08-05-2022,Quicksilver,3,737,306,80,12,68,90,19,4,2,2,0
08-05-2022,Quicksilver,2,634,622,390,2,388,85,47,30,12,18,3
08-05-2022,Discovery,1,210,78,169,102,67,80,35,66,49,17,5
08-05-2022,CelestialInterface,2,991,148,8,3,5,51,45,14,4,10,0
08-05-2022,GrayPanthers,2,280,4,118,81,37,97,16,68,4,64,2
08-05-2022,ImpactTraining,1,307,91,33,3,30,82,67,22,1,21,0
08-05-2022,Aurora,2,635,397,342,215,127,69,34,50,31,19,1
08-05-2023,BitterLaser,3,801,361,451,57,394,81,68,67,33,34,8
08-05-2023,Mustangs,1,833,345,670,449,221,59,27,22,16,6,0
08-05-2023,GrayPanthers,3,443,377,290,182,108,76,72,64,27,37,7
08-05-2023,Mustangs,3,293,202,29,15,14,60,53,47,16,31,4
08-05-2023,Mustangs,2,313,170,273,91,182,51,8,34,11,23,1
08-05-2023,ImpactTraining,1,136,116,110,39,71,92,2,61,12,49,1
08-05-2023,CelestialInterface,2,688,657,204,163,41,51,41,14,1,13,1
08-05-2023,Discovery,2,173,62,33,16,17,88,63,76,5,71,10
08-05-2023,ImpactTraining,2,685,300,83,70,13,58,40,30,20,10,3
08-06-2021,CelestialInterface,2,257,153,39,27,12,68,13,26,8,18,0
08-06-2021,BitterLaser,2,773,552,437,109,328,51,12,3,1,2,0
08-06-2021,Mustangs,3,634,559,572,9,563,87,35,25,11,14,1
08-06-2021,Quicksilver,3,251,106,241,196,45,81,51,0,0,0,0
08-06-2022,Discovery,1,406,149,204,116,88,67,59,42,36,6,0
08-06-2022,BitterLaser,2,935,210,99,98,1,65,16,10,2,8,0
08-06-2022,Quicksilver,3,302,14,96,0,96,63,1,52,43,9,2
08-06-2022,CelestialInterface,3,725,281,599,23,576,73,70,11,8,3,0
08-06-2022,Discovery,2,630,43,281,249,32,67,54,21,18,3,0
08-06-2022,GrayPanthers,1,492,163,483,387,96,80,9,12,0,12,0
08-06-2022,ImpactTraining,2,926,831,386,150,236,73,0,64,39,25,4
08-06-2022,PrimeSeven,3,227,85,113,86,27,68,46,20,6,14,0
08-06-2022,Aurora,1,186,99,94,47,47,70,44,17,12,5,1
08-06-2023,BitterLaser,2,705,156,412,169,243,84,27,75,46,29,2
08-06-2023,Aurora,2,115,48,11,9,2,91,56,19,9,10,1
08-06-2023,Mustangs,2,189,8,26,3,23,53,36,7,2,5,0
08-06-2023,GrayPanthers,3,608,12,352,281,71,63,32,61,43,18,1
08-07-2021,CelestialInterface,1,492,209,45,13,32,71,35,52,31,21,5
08-07-2021,PrimeSeven,1,883,312,852,534,318,100,44,26,1,25,1
08-07-2021,PrimeSeven,3,411,376,38,30,8,51,29,49,38,11,4
08-07-2021,Aurora,3,954,727,898,795,103,54,37,46,11,35,2
08-07-2021,Quicksilver,3,442,278,155,104,51,88,1,37,25,12,1
08-07-2021,BitterLaser,3,336,302,329,99,230,72,43,14,8,6,1
08-07-2021,BitterLaser,3,791,789,747,505,242,83,44,19,15,4,0
08-07-2021,GrayPanthers,2,191,83,163,15,148,71,18,61,49,12,8
08-07-2022,BitterLaser,3,319,27,136,22,114,90,76,40,27,13,5
08-07-2022,Aurora,2,741,657,562,394,168,74,46,13,1,12,0
08-07-2022,BitterLaser,2,388,257,151,8,143,51,13,41,37,4,1
08-07-2022,CelestialInterface,3,839,538,197,91,106,53,5,14,2,12,1
08-07-2022,Aurora,2,929,226,304,50,254,90,76,70,18,52,9
08-07-2022,Mustangs,1,450,175,219,183,36,92,68,53,48,5,3
08-07-2022,Mustangs,1,564,498,461,223,238,71,22,62,56,6,2
08-07-2022,Mustangs,2,853,366,790,231,559,77,27,20,16,4,2
08-07-2022,Discovery,1,389,262,303,278,25,66,43,48,25,23,3
08-07-2022,Discovery,2,929,489,405,302,103,50,46,11,3,8,0
08-07-2022,BitterLaser,2,971,122,243,171,72,57,54,29,7,22,2
08-07-2022,Aurora,2,250,208,17,16,1,62,42,49,3,46,2
08-07-2022,GrayPanthers,2,387,342,85,77,8,81,1,8,6,2,0
08-07-2022,BitterLaser,3,466,380,89,2,87,57,2,35,29,6,4
08-07-2022,Aurora,1,746,473,111,54,57,55,53,45,21,24,3
08-07-2022,Honeycomb,3,137,76,118,101,17,75,29,22,3,19,2
08-07-2022,GrayPanthers,1,649,44,275,264,11,70,24,63,7,56,7
08-07-2023,CelestialInterface,2,928,860,400,157,243,67,34,40,24,16,1
08-07-2023,BitterLaser,2,994,607,862,288,574,93,23,24,1,23,1
08-07-2023,Aurora,1,510,266,372,81,291,95,83,34,8,26,2
08-07-2023,PrimeSeven,3,579,120,459,0,459,75,23,63,39,24,3
08-07-2023,ImpactTraining,2,986,530,326,320,6,70,57,19,1,18,1
08-07-2023,PrimeSeven,3,832,172,97,57,40,54,15,22,2,20,1
08-07-2023,GrayPanthers,1,835,106,755,510,245,81,33,16,1,15,0
08-07-2023,Aurora,3,143,115,2,1,1,60,38,9,4,5,0
08-07-2023,CelestialInterface,2,806,553,149,121,28,93,70,62,35,27,8
08-07-2023,BitterLaser,3,600,25,562,78,484,86,26,56,39,17,6
08-07-2023,GrayPanthers,1,202,97,9,4,5,67,3,27,13,14,3
08-07-2023,GrayPanthers,2,385,153,331,245,86,61,28,23,14,9,2
08-08-2021,CelestialInterface,3,982,883,447,194,253,86,82,58,41,17,3
08-08-2021,BitterLaser,2,143,133,104,92,12,56,54,41,10,31,1
08-08-2021,PrimeSeven,1,453,305,183,42,141,76,55,25,24,1,0
08-08-2021,Quicksilver,1,958,180,684,135,549,58,16,47,12,35,5
08-08-2021,Mustangs,2,465,333,253,112,141,92,64,26,12,14,1
08-08-2021,Discovery,3,930,386,527,218,309,73,30,41,33,8,5
08-08-2021,Honeycomb,3,382,91,294,39,255,54,53,21,10,11,0
08-08-2021,PrimeSeven,3,526,325,375,264,111,100,1,41,16,25,3
08-08-2021,Aurora,1,996,152,543,303,240,76,65,33,29,4,2
08-08-2021,PrimeSeven,3,412,211,237,222,15,73,45,52,36,16,5
08-08-2022,PrimeSeven,2,746,409,36,30,6,67,15,44,14,30,5
08-08-2022,PrimeSeven,1,765,201,244,177,67,54,31,9,7,2,0
08-08-2022,Discovery,3,795,403,104,43,61,75,14,20,12,8,2
08-08-2022,ImpactTraining,3,502,90,273,57,216,78,52,25,4,21,0
08-08-2022,GrayPanthers,2,782,66,637,199,438,84,13,26,3,23,2
08-08-2022,Discovery,3,567,287,245,101,144,57,18,13,11,2,0
08-08-2023,ImpactTraining,1,224,166,212,142,70,75,37,23,10,13,1
08-08-2023,Quicksilver,2,100,9,81,15,66,65,3,57,15,42,4
08-08-2023,GrayPanthers,3,459,446,31,9,22,57,50,35,19,16,3
08-08-2023,Honeycomb,3,147,118,27,12,15,99,27,29,8,21,2
08-08-2023,PrimeSeven,2,925,786,525,88,437,58,45,57,1,56,1
08-08-2023,ImpactTraining,3,134,44,85,52,33,91,69,4,3,1,0
08-08-2023,Quicksilver,3,857,82,201,60,141,69,35,9,5,4,0
08-08-2023,Discovery,1,971,388,441,438,3,66,56,53,9,44,3
08-09-2021,BitterLaser,1,453,343,248,42,206,61,47,1,0,1,0
08-09-2021,Quicksilver,3,635,557,407,405,2,93,68,32,23,9,1
08-09-2021,Aurora,1,502,417,388,42,346,74,59,54,38,16,3
08-09-2021,Aurora,3,169,13,154,70,84,62,61,47,26,21,0
08-09-2021,ImpactTraining,2,919,607,212,121,91,95,66,92,56,36,5
08-09-2021,PrimeSeven,3,240,176,44,8,36,50,14,22,20,2,1
08-09-2021,PrimeSeven,1,295,197,49,8,41,58,41,17,9,8,0
08-09-2021,ImpactTraining,2,369,287,281,245,36,96,34,74,9,65,6
08-09-2021,CelestialInterface,3,497,39,454,174,280,100,53,8,7,1,0
08-09-2021,Mustangs,1,430,328,86,54,32,88,56,86,59,27,11
08-09-2021,Discovery,3,207,34,196,83,113,57,31,0,0,0,0
08-09-2021,Mustangs,2,735,590,251,200,51,73,28,5,0,5,0
08-09-2021,Honeycomb,1,135,80,19,3,16,99,36,79,5,74,5
08-09-2022,GrayPanthers,2,946,410,352,258,94,77,6,37,25,12,3
08-09-2022,Aurora,2,318,216,113,71,42,69,26,47,36,11,1
08-09-2022,Quicksilver,3,745,558,11,1,10,67,25,58,27,31,4
08-09-2022,PrimeSeven,1,491,318,218,202,16,85,72,34,15,19,2
08-09-2022,Aurora,1,991,463,405,90,315,58,52,46,34,12,1
08-09-2022,Discovery,1,915,541,282,204,78,67,16,30,24,6,1
08-09-2022,CelestialInterface,2,542,187,139,5,134,93,91,25,20,5,0
08-09-2022,Mustangs,1,754,598,205,56,149,78,51,43,20,23,2
08-09-2023,Honeycomb,1,337,50,197,86,111,58,21,13,2,11,0
08-09-2023,Honeycomb,1,468,327,254,176,78,95,48,88,83,5,5
08-09-2023,Discovery,2,160,36,142,80,62,66,43,44,21,23,2
08-09-2023,ImpactTraining,2,830,687,46,29,17,95,47,60,54,6,2
08-09-2023,ImpactTraining,3,844,239,70,28,42,79,6,25,9,16,0
08-09-2023,Mustangs,2,432,376,175,39,136,87,64,3,1,2,0
08-09-2023,GrayPanthers,3,618,415,495,316,179,52,38,1,0,1,0
08-09-2023,BitterLaser,1,156,95,96,86,10,63,24,52,34,18,1
08-10-2021,Quicksilver,2,742,220,193,116,77,99,7,15,3,12,1
08-10-2021,Honeycomb,3,719,584,501,164,337,68,41,48,22,26,1
08-10-2021,CelestialInterface,2,491,134,365,10,355,57,5,53,25,28,4
08-10-2021,Quicksilver,3,377,168,307,71,236,79,20,63,51,12,7
08-10-2021,CelestialInterface,3,767,528,221,137,84,73,46,16,9,7,1
08-10-2021,CelestialInterface,3,996,570,792,409,383,77,41,74,29,45,1
08-10-2021,CelestialInterface,3,610,285,300,269,31,75,15,47,40,7,5
08-10-2021,GrayPanthers,1,582,316,414,110,304,50,13,32,26,6,3
08-10-2021,Aurora,1,889,147,8,1,7,52,14,17,7,10,1
08-10-2021,Honeycomb,1,962,361,853,558,295,90,5,74,26,48,3
08-10-2022,Aurora,2,683,532,410,355,55,72,39,25,8,17,0
08-10-2022,ImpactTraining,3,535,304,507,450,57,89,72,42,1,41,2
08-10-2022,GrayPanthers,1,859,799,853,253,600,59,46,49,9,40,6
08-10-2022,BitterLaser,2,667,464,546,357,189,78,7,38,25,13,3
08-10-2022,BitterLaser,1,960,321,939,287,652,98,27,79,44,35,2
08-10-2022,Aurora,2,459,300,173,65,108,69,27,37,0,37,4
08-10-2022,Aurora,1,750,388,571,7,564,88,1,18,10,8,1
08-10-2022,Quicksilver,3,142,66,42,36,6,58,42,36,25,11,3
08-10-2022,Discovery,1,129,118,17,15,2,78,8,8,1,7,0
08-10-2023,Quicksilver,1,167,158,121,30,91,67,43,55,26,29,6
08-10-2023,Mustangs,2,551,487,25,22,3,80,39,78,70,8,10
08-10-2023,CelestialInterface,3,969,878,623,337,286,50,7,18,5,13,0
08-10-2023,BitterLaser,3,884,671,819,483,336,52,1,11,7,4,0
08-10-2023,PrimeSeven,3,511,116,76,0,76,60,16,16,0,16,1
08-10-2023,Honeycomb,2,759,413,653,314,339,59,27,47,9,38,2
08-10-2023,Quicksilver,3,271,146,5,4,1,75,57,69,31,38,0
08-11-2021,CelestialInterface,1,187,113,23,17,6,53,48,13,7,6,0
08-11-2021,BitterLaser,1,711,77,207,40,167,91,48,73,20,53,9
08-11-2021,PrimeSeven,1,402,246,357,88,269,51,3,19,16,3,1
08-11-2021,Quicksilver,3,207,50,0,0,0,82,78,62,40,22,6
08-11-2021,Mustangs,1,765,663,297,14,283,72,59,51,23,28,1
08-11-2021,CelestialInterface,1,863,306,231,127,104,82,5,54,12,42,2
08-11-2021,GrayPanthers,2,182,111,178,69,109,85,22,72,41,31,8
08-11-2021,Aurora,2,382,197,250,215,35,68,36,63,31,32,2
08-11-2021,Aurora,2,523,241,36,20,16,58,44,17,13,4,1
08-11-2021,Discovery,1,306,145,147,82,65,65,37,24,14,10,1
08-11-2021,Discovery,1,241,163,77,61,16,75,10,66,14,52,6
08-11-2021,Mustangs,3,993,35,353,276,77,87,47,25,3,22,0
08-11-2022,CelestialInterface,3,742,396,377,328,49,59,33,46,13,33,0
08-11-2022,Mustangs,2,969,621,123,86,37,73,39,15,10,5,0
08-11-2022,Quicksilver,3,983,281,462,404,58,87,77,63,17,46,4
08-11-2022,Honeycomb,1,641,246,63,40,23,59,43,5,1,4,0
08-11-2022,Discovery,2,339,185,204,154,50,87,27,38,24,14,2
08-11-2022,Aurora,3,329,198,94,44,50,87,50,18,14,4,1
08-11-2022,GrayPanthers,1,320,9,277,11,266,74,57,13,1,12,0
08-11-2022,Mustangs,1,125,70,65,23,42,66,37,61,24,37,8
08-11-2022,GrayPanthers,2,627,507,402,310,92,87,53,27,14,13,1
08-11-2022,BitterLaser,2,844,623,712,183,529,95,57,50,15,35,1
08-11-2022,Aurora,1,728,622,675,441,234,75,2,41,20,21,4
08-11-2022,CelestialInterface,3,346,147,247,115,132,95,57,92,49,43,4
08-11-2022,Quicksilver,1,757,307,40,12,28,65,29,23,1,22,0
08-11-2022,Aurora,1,696,603,641,252,389,74,45,44,35,9,5
08-11-2023,BitterLaser,3,658,626,43,10,33,57,6,22,10,12,0
08-11-2023,CelestialInterface,1,202,146,3,0,3,71,42,62,13,49,3
08-11-2023,Honeycomb,3,428,229,291,162,129,97,24,23,6,17,2
08-11-2023,CelestialInterface,3,713,263,540,526,14,87,49,42,21,21,0
08-11-2023,Honeycomb,1,200,24,47,19,28,63,34,10,7,3,0
08-12-2021,Mustangs,3,843,186,387,125,262,52,0,47,20,27,4
08-12-2021,Discovery,1,450,138,432,339,93,87,12,35,18,17,2
08-12-2021,Discovery,1,988,478,564,11,553,90,72,39,0,39,4
08-12-2021,Aurora,1,766,405,132,94,38,86,45,81,80,1,0
08-12-2021,GrayPanthers,2,388,7,320,222,98,86,36,84,33,51,2
08-12-2021,ImpactTraining,1,283,84,247,48,199,65,44,33,14,19,3
08-12-2021,GrayPanthers,3,189,1,123,83,40,88,57,32,16,16,1
08-12-2021,Mustangs,3,687,60,636,202,434,78,31,11,2,9,0
08-12-2021,Mustangs,3,956,632,229,153,76,74,68,38,14,24,4
08-12-2021,Quicksilver,1,487,166,402,349,53,90,51,78,62,16,3
08-12-2022,GrayPanthers,2,519,78,346,144,202,61,17,46,19,27,0
08-12-2022,ImpactTraining,2,831,95,766,310,456,87,46,76,73,3,10
08-12-2022,Discovery,2,560,293,103,85,18,74,69,69,40,29,0
08-12-2022,Quicksilver,3,346,15,59,20,39,87,72,43,24,19,4
08-12-2022,BitterLaser,2,817,278,200,47,153,73,16,18,9,9,1
08-12-2022,Mustangs,3,302,99,178,162,16,63,60,42,39,3,4
08-12-2022,CelestialInterface,3,873,463,824,657,167,79,51,48,4,44,2
08-12-2022,Mustangs,1,207,9,63,61,2,52,21,33,8,25,3
08-12-2023,PrimeSeven,1,155,136,60,8,52,92,81,49,6,43,2
08-12-2023,Discovery,3,944,504,903,867,36,82,25,18,10,8,0
08-12-2023,BitterLaser,2,718,334,160,67,93,68,41,27,24,3,2
08-12-2023,ImpactTraining,1,660,480,549,331,218,77,73,49,6,43,6
08-12-2023,Aurora,2,616,270,440,412,28,89,79,64,54,10,5
08-12-2023,PrimeSeven,2,998,809,481,165,316,86,54,56,4,52,2
08-12-2023,Quicksilver,1,607,518,411,200,211,95,8,2,0,2,0
08-12-2023,PrimeSeven,2,162,9,74,50,24,65,33,30,1,29,1
08-12-2023,Honeycomb,3,549,233,50,21,29,91,90,17,12,5,0
08-12-2023,GrayPanthers,2,406,185,3,0,3,51,27,37,8,29,1
09-01-2021,Aurora,3,296,217,200,195,5,98,75,12,6,6,0
09-01-2021,BitterLaser,3,968,627,426,399,27,61,43,2,0,2,0
09-01-2021,BitterLaser,3,546,422,327,49,278,63,33,24,19,5,0
09-01-2021,CelestialInterface,1,342,190,280,92,188,77,19,9,0,9,0
09-01-2021,BitterLaser,2,281,277,129,66,63,52,42,2,1,1,0
09-01-2021,BitterLaser,2,186,67,173,160,13,98,85,75,20,55,5
09-01-2021,GrayPanthers,3,435,211,92,39,53,90,74,17,7,10,1
09-01-2022,Aurora,3,554,153,192,41,151,80,9,76,0,76,3
09-01-2022,CelestialInterface,3,662,530,127,95,32,53,24,13,2,11,0
09-01-2022,Aurora,1,715,474,196,149,47,78,15,67,56,11,1
09-01-2022,Discovery,1,685,352,580,149,431,53,41,29,1,28,0
09-01-2022,ImpactTraining,3,524,193,232,39,193,56,35,51,44,7,3
09-01-2022,Honeycomb,3,417,13,131,130,1,83,28,14,4,10,1
09-01-2022,GrayPanthers,2,870,165,158,34,124,85,70,37,30,7,4
09-01-2022,Aurora,3,185,37,87,6,81,52,0,46,7,39,5
09-01-2022,Aurora,2,879,505,81,53,28,88,79,20,12,8,1
09-01-2022,BitterLaser,1,874,625,12,2,10,70,44,12,7,5,0
09-01-2022,GrayPanthers,2,675,480,161,45,116,72,4,4,0,4,0
09-01-2022,BitterLaser,1,854,269,666,552,114,88,26,22,6,16,2
09-01-2022,BitterLaser,3,581,386,459,419,40,92,4,13,9,4,0
09-01-2022,BitterLaser,2,912,909,825,66,759,92,85,42,29,13,1
09-01-2022,Mustangs,2,818,448,48,17,31,65,17,4,3,1,0
09-01-2023,PrimeSeven,3,542,273,146,145,1,52,43,27,26,1,2
09-01-2023,GrayPanthers,3,677,22,607,208,399,69,55,48,11,37,1
09-01-2023,Mustangs,2,701,590,446,340,106,84,31,30,6,24,1
09-01-2023,Honeycomb,2,632,363,32,12,20,96,79,20,8,12,2
09-01-2023,Discovery,2,769,129,753,108,645,92,4,10,0,10,0
09-01-2023,PrimeSeven,1,699,304,652,135,517,76,72,18,17,1,0
09-01-2023,PrimeSeven,1,253,240,48,12,36,87,84,36,24,12,1
09-01-2023,BitterLaser,1,598,204,373,219,154,63,27,15,11,4,0
09-01-2023,Mustangs,3,519,140,123,38,85,58,6,13,10,3,0
09-02-2021,Quicksilver,3,676,190,472,347,125,52,19,26,0,26,1
09-02-2022,Discovery,2,249,9,51,12,39,79,32,0,0,0,0
09-02-2022,Aurora,3,631,579,200,1,199,50,32,28,2,26,2
09-02-2022,Discovery,1,791,235,342,116,226,74,71,12,0,12,0
09-02-2022,Discovery,1,139,116,90,77,13,84,53,17,5,12,1
09-02-2022,Discovery,2,366,111,211,190,21,90,30,71,7,64,7
09-02-2022,CelestialInterface,2,425,243,60,7,53,85,36,18,5,13,0
09-02-2022,Quicksilver,2,171,20,141,97,44,77,72,74,32,42,3
09-02-2022,PrimeSeven,3,991,982,632,183,449,53,4,30,1,29,2
09-02-2022,BitterLaser,1,956,232,296,260,36,53,24,4,0,4,0
09-02-2022,Mustangs,3,254,131,36,3,33,70,31,50,35,15,1
09-02-2022,Quicksilver,1,452,71,394,208,186,60,18,2,0,2,0
09-02-2022,Aurora,2,964,206,343,340,3,97,49,60,29,31,2
09-02-2022,PrimeSeven,2,872,221,360,118,242,89,83,74,42,32,0
09-02-2022,ImpactTraining,1,429,427,261,216,45,85,70,58,50,8,5
09-02-2023,Honeycomb,3,218,26,209,119,90,94,44,72,16,56,9
09-02-2023,Discovery,1,965,522,733,161,572,63,28,5,3,2,0
09-02-2023,Discovery,3,574,246,508,458,50,63,10,16,1,15,1
09-02-2023,CelestialInterface,3,182,25,113,94,19,83,29,15,10,5,0
09-02-2023,PrimeSeven,1,576,496,256,31,225,71,9,34,22,12,4
09-03-2021,Aurora,2,303,34,234,175,59,87,86,61,20,41,6
09-03-2021,BitterLaser,1,737,398,595,118,477,53,11,30,13,17,3
09-03-2021,ImpactTraining,3,721,464,444,209,235,99,16,75,6,69,4
09-03-2021,ImpactTraining,2,156,116,5,0,5,57,55,28,12,16,0
09-03-2021,CelestialInterface,1,1000,352,437,369,68,58,40,57,42,15,5
09-03-2021,Mustangs,1,608,169,578,147,431,74,71,48,4,44,0
09-03-2021,Aurora,1,278,68,151,119,32,96,55,44,42,2,3
09-03-2022,Honeycomb,3,974,310,910,816,94,58,56,53,16,37,4
09-03-2022,ImpactTraining,2,881,617,700,160,540,82,48,80,20,60,1
09-03-2022,PrimeSeven,1,293,218,19,1,18,50,13,35,17,18,1
09-03-2022,Mustangs,1,369,284,191,129,62,85,36,34,6,28,4
09-03-2023,ImpactTraining,3,779,528,461,46,415,91,44,10,3,7,0
09-03-2023,BitterLaser,3,558,195,206,176,30,79,38,39,38,1,4
09-03-2023,GrayPanthers,1,520,7,460,281,179,98,44,88,25,63,11
09-03-2023,Honeycomb,3,217,112,59,41,18,78,11,66,3,63,0
09-03-2023,Quicksilver,2,716,522,661,46,615,73,36,59,41,18,2
09-03-2023,CelestialInterface,2,411,78,149,126,23,54,52,35,32,3,3
09-03-2023,Honeycomb,3,858,524,613,154,459,91,46,68,59,9,7
09-03-2023,Discovery,2,709,454,115,65,50,62,50,55,14,41,2
09-03-2023,Aurora,1,746,299,670,567,103,84,41,5,4,1,0
09-04-2021,Aurora,1,674,671,516,288,228,60,47,24,14,10,0
09-04-2021,Aurora,2,293,199,223,160,63,88,18,63,10,53,4
09-04-2021,Honeycomb,3,543,128,487,449,38,58,52,20,8,12,1
09-04-2022,BitterLaser,2,588,305,206,153,53,100,41,97,64,33,11
09-04-2022,PrimeSeven,1,623,69,616,165,451,58,55,7,3,4,0
09-04-2022,Honeycomb,2,985,40,152,92,60,66,27,5,2,3,0
09-04-2022,Discovery,2,705,30,310,208,102,52,19,22,19,3,1
09-04-2022,Honeycomb,2,198,116,44,12,32,86,1,72,71,1,1
09-04-2022,Mustangs,3,640,363,421,57,364,86,13,7,4,3,0
09-04-2022,Discovery,1,535,372,472,8,464,91,3,77,26,51,1
09-04-2023,Quicksilver,1,328,149,78,57,21,99,67,3,2,1,0
09-04-2023,Mustangs,1,526,66,307,98,209,78,9,11,2,9,0
09-04-2023,Quicksilver,1,921,466,685,370,315,53,40,47,1,46,6
09-04-2023,CelestialInterface,1,645,100,288,80,208,78,64,29,24,5,0
09-04-2023,Aurora,1,177,100,112,54,58,56,20,24,8,16,0
09-04-2023,Aurora,2,225,75,82,44,38,81,18,54,51,3,5
09-04-2023,CelestialInterface,3,931,406,329,186,143,54,28,39,7,32,1
09-04-2023,Discovery,2,191,54,62,18,44,82,14,52,12,40,4
09-04-2023,Honeycomb,1,470,298,384,191,193,60,38,34,33,1,0
09-05-2021,GrayPanthers,3,635,586,140,41,99,92,29,40,21,19,2
09-05-2021,CelestialInterface,3,835,436,447,191,256,53,0,46,10,36,5
09-05-2021,CelestialInterface,2,254,166,39,9,30,57,5,42,18,24,1
09-05-2021,ImpactTraining,3,999,433,584,263,321,98,51,95,41,54,5
09-05-2021,PrimeSeven,3,564,202,143,19,124,55,8,54,25,29,3
09-05-2022,Discovery,2,386,101,247,121,126,64,4,57,34,23,5
09-05-2022,Aurora,1,694,250,325,16,309,83,58,42,29,13,5
09-05-2022,ImpactTraining,2,120,10,99,93,6,50,15,38,35,3,2
09-05-2022,Discovery,2,719,604,310,214,96,85,1,54,4,50,0
09-05-2022,Discovery,3,497,452,264,193,71,70,15,5,2,3,0
09-05-2022,CelestialInterface,1,906,406,884,440,444,61,23,43,36,7,0
09-05-2023,BitterLaser,2,367,32,326,205,121,67,45,10,0,10,0
09-05-2023,ImpactTraining,2,793,440,344,9,335,82,63,70,6,64,5
09-05-2023,Mustangs,1,401,338,145,20,125,79,1,19,14,5,1
09-05-2023,ImpactTraining,2,398,248,47,26,21,98,88,88,19,69,9
09-06-2021,GrayPanthers,1,855,735,818,760,58,70,14,50,27,23,0
09-06-2021,Discovery,2,678,402,611,94,517,100,92,90,25,65,1
09-06-2021,Mustangs,1,703,587,355,202,153,93,51,29,4,25,1
09-06-2021,Quicksilver,1,868,659,545,241,304,70,66,28,2,26,1
09-06-2021,CelestialInterface,2,387,3,133,75,58,61,10,50,16,34,4
09-06-2021,ImpactTraining,2,397,266,21,10,11,58,44,5,4,1,0
09-06-2021,GrayPanthers,3,983,294,844,722,122,68,67,9,6,3,0
09-06-2022,BitterLaser,1,455,105,6,2,4,71,21,25,8,17,1
09-06-2022,PrimeSeven,2,705,298,71,59,12,82,81,44,10,34,1
09-06-2022,Aurora,3,399,131,297,192,105,100,27,80,37,43,4
09-06-2022,Mustangs,3,651,103,152,34,118,76,69,9,8,1,0
09-06-2022,Aurora,1,378,34,342,325,17,62,44,9,7,2,0
09-06-2022,Honeycomb,1,240,212,118,116,2,67,40,30,1,29,3
09-06-2022,Mustangs,2,870,854,16,7,9,70,10,37,24,13,1
09-06-2023,Aurora,3,658,621,379,200,179,94,89,16,12,4,1
09-06-2023,Mustangs,2,704,555,216,71,145,94,74,92,9,83,9
09-06-2023,PrimeSeven,3,582,279,295,125,170,67,30,33,4,29,2
09-06-2023,Honeycomb,2,497,275,133,92,41,75,28,62,57,5,6
09-06-2023,PrimeSeven,2,858,244,475,36,439,53,41,27,22,5,1
09-06-2023,CelestialInterface,3,170,38,80,30,50,58,1,42,32,10,4
09-06-2023,BitterLaser,2,279,99,143,73,70,74,21,30,7,23,3
09-06-2023,Quicksilver,3,674,171,150,77,73,58,50,50,10,40,1
09-06-2023,Quicksilver,2,528,462,383,233,150,62,22,33,13,20,3
09-06-2023,CelestialInterface,1,316,260,159,62,97,53,34,29,2,27,0
09-07-2021,Discovery,2,933,303,769,72,697,65,34,48,1,47,0
09-07-2021,ImpactTraining,2,173,139,93,4,89,76,31,20,1,19,1
09-07-2021,GrayPanthers,2,133,45,41,21,20,81,79,16,5,11,0
09-07-2021,Discovery,3,878,222,101,80,21,65,59,29,26,3,3
09-07-2021,Honeycomb,1,550,531,441,378,63,60,8,21,19,2,1
09-07-2021,Mustangs,1,359,108,67,28,39,58,14,48,44,4,5
09-07-2021,GrayPanthers,3,686,488,200,125,75,80,27,26,5,21,0
09-07-2022,PrimeSeven,1,331,57,81,27,54,65,15,6,1,5,0
09-07-2022,Honeycomb,3,268,172,251,17,234,96,69,89,64,25,6
09-07-2022,PrimeSeven,3,505,29,463,394,69,54,0,19,6,13,1
09-07-2022,Aurora,1,844,836,576,28,548,54,8,25,6,19,1
09-07-2022,ImpactTraining,2,975,520,275,267,8,75,13,54,41,13,1
09-07-2022,Aurora,1,561,140,323,252,71,71,22,1,0,1,0
09-07-2022,BitterLaser,1,457,106,420,127,293,100,28,52,13,39,3
09-07-2022,GrayPanthers,3,274,78,265,225,40,94,34,87,43,44,0
09-07-2022,CelestialInterface,3,881,643,693,682,11,67,37,26,8,18,0
09-07-2023,CelestialInterface,1,469,46,409,217,192,56,21,10,8,2,0
09-07-2023,Mustangs,2,984,488,100,40,60,82,2,55,20,35,1
09-07-2023,Honeycomb,1,959,889,4,1,3,88,82,40,6,34,5
09-07-2023,Quicksilver,1,128,97,6,1,5,96,31,7,5,2,0
09-07-2023,GrayPanthers,2,526,334,249,178,71,65,23,46,28,18,1
09-07-2023,Honeycomb,2,483,299,409,310,99,59,6,38,17,21,0
09-07-2023,GrayPanthers,3,664,96,424,295,129,75,67,14,5,9,0
09-07-2023,PrimeSeven,2,637,364,488,109,379,89,34,23,3,20,2
09-07-2023,CelestialInterface,1,879,730,510,399,111,78,33,12,3,9,0
09-07-2023,Aurora,1,121,108,115,39,76,84,14,37,34,3,3
09-07-2023,Aurora,3,670,650,352,78,274,81,55,13,1,12,0
09-08-2021,ImpactTraining,2,126,124,62,57,5,56,38,12,2,10,0
09-08-2021,Mustangs,3,484,124,44,29,15,55,38,20,15,5,1
09-08-2021,PrimeSeven,3,104,67,18,12,6,50,5,44,30,14,2
09-08-2021,Mustangs,3,568,147,283,1,282,66,64,21,5,16,2
09-08-2021,CelestialInterface,1,839,607,811,236,575,92,40,33,18,15,3
09-08-2021,Mustangs,2,557,60,2,0,2,58,32,30,11,19,1
09-08-2021,Quicksilver,2,120,97,103,2,101,90,43,62,4,58,2
09-08-2021,Quicksilver,2,808,797,367,201,166,68,21,10,6,4,0
09-08-2021,CelestialInterface,1,361,245,100,1,99,95,2,2,0,2,0
09-08-2021,Mustangs,1,171,50,126,112,14,92,26,45,30,15,0
09-08-2021,Mustangs,2,428,138,126,44,82,74,35,51,43,8,6
09-08-2021,Aurora,2,943,643,743,716,27,54,9,17,1,16,0
09-08-2021,Honeycomb,3,485,265,1,0,1,55,2,7,6,1,0
09-08-2021,GrayPanthers,2,872,597,596,115,481,98,89,1,0,1,0
09-08-2021,ImpactTraining,2,169,55,8,6,2,61,43,11,3,8,0
09-08-2021,Aurora,3,209,165,102,93,9,85,40,73,22,51,7
09-08-2021,CelestialInterface,2,405,81,46,28,18,93,65,80,72,8,5
09-08-2021,GrayPanthers,1,312,212,250,163,87,58,20,37,33,4,4
09-08-2021,Quicksilver,1,649,308,89,83,6,93,81,41,40,1,1
09-08-2022,Honeycomb,1,695,536,382,98,284,62,19,16,2,14,0
09-08-2022,BitterLaser,3,771,92,181,95,86,70,5,52,44,8,2
09-08-2022,BitterLaser,1,668,653,329,131,198,58,53,30,4,26,2
09-08-2022,BitterLaser,3,612,287,353,209,144,62,25,60,12,48,0
09-08-2022,Discovery,3,556,245,55,43,12,50,26,34,7,27,0
09-08-2023,PrimeSeven,2,890,622,647,392,255,53,28,41,28,13,4
09-08-2023,ImpactTraining,1,543,440,483,156,327,53,46,37,23,14,2
09-08-2023,GrayPanthers,1,281,215,117,78,39,54,22,33,7,26,1
09-08-2023,PrimeSeven,1,884,825,782,770,12,73,4,41,2,39,4
09-08-2023,Quicksilver,3,316,173,276,20,256,81,13,41,31,10,5
09-08-2023,BitterLaser,1,210,4,53,34,19,88,23,26,0,26,1
09-08-2023,GrayPanthers,2,745,288,64,40,24,92,15,68,12,56,7
09-08-2023,GrayPanthers,1,573,262,59,32,27,90,47,83,62,21,0
09-08-2023,GrayPanthers,2,684,55,396,108,288,92,24,77,3,74,5
09-08-2023,GrayPanthers,3,219,20,5,3,2,72,5,25,15,10,2
09-08-2023,Quicksilver,2,711,177,356,249,107,54,49,50,28,22,2
09-08-2023,Discovery,3,813,93,756,295,461,69,54,2,1,1,0
09-08-2023,Honeycomb,3,129,108,123,11,112,83,38,58,6,52,3
09-09-2021,CelestialInterface,2,211,56,87,65,22,73,17,49,12,37,2
09-09-2021,ImpactTraining,3,452,126,68,18,50,100,37,11,0,11,0
09-09-2021,Honeycomb,3,559,238,99,39,60,59,33,25,0,25,2
09-09-2021,Discovery,3,541,374,472,424,48,79,34,76,25,51,3
09-09-2021,Quicksilver,2,330,121,300,186,114,75,37,23,10,13,1
09-09-2021,GrayPanthers,2,524,432,68,43,25,92,77,48,34,14,0
09-09-2021,ImpactTraining,3,557,0,126,110,16,87,67,85,10,75,11
09-09-2021,Aurora,2,894,806,403,329,74,93,57,90,15,75,6
09-09-2021,Honeycomb,1,931,783,113,57,56,55,4,0,0,0,0
09-09-2021,PrimeSeven,2,297,8,7,2,5,64,58,36,17,19,2
09-09-2021,Quicksilver,2,976,534,164,46,118,88,68,78,60,18,3
09-09-2022,ImpactTraining,2,194,33,24,14,10,73,13,2,0,2,0
09-09-2022,Quicksilver,3,926,724,680,318,362,67,61,48,30,18,2
09-09-2022,ImpactTraining,1,355,326,108,101,7,57,43,48,40,8,3
09-09-2022,Aurora,2,323,17,75,25,50,73,30,39,9,30,2
09-09-2022,PrimeSeven,3,588,557,176,111,65,61,27,59,13,46,6
09-09-2022,GrayPanthers,2,900,539,174,172,2,79,16,52,51,1,6
09-09-2022,PrimeSeven,3,670,389,566,559,7,76,53,68,48,20,7
09-09-2022,ImpactTraining,2,551,132,513,189,324,94,77,37,12,25,2
09-09-2022,BitterLaser,1,837,374,698,425,273,76,7,38,0,38,2
09-09-2022,CelestialInterface,2,366,194,104,47,57,55,2,50,10,40,5
09-09-2022,ImpactTraining,1,646,460,441,431,10,96,59,58,52,6,1
09-09-2022,BitterLaser,3,391,126,308,256,52,85,66,27,25,2,1
09-09-2022,PrimeSeven,3,733,128,58,43,15,99,32,98,10,88,9
09-09-2022,PrimeSeven,1,166,94,31,9,22,87,2,71,69,2,6
09-09-2022,ImpactTraining,2,252,66,200,199,1,62,1,48,2,46,6
09-09-2023,PrimeSeven,2,783,165,108,80,28,91,81,90,60,30,9
09-09-2023,PrimeSeven,3,882,15,803,543,260,51,7,31,19,12,1
09-09-2023,Discovery,2,625,100,537,459,78,65,22,22,7,15,0
09-09-2023,Honeycomb,3,387,320,306,145,161,100,22,15,0,15,0
09-09-2023,ImpactTraining,3,575,187,426,212,214,68,65,2,0,2,0
09-09-2023,BitterLaser,3,203,26,172,133,39,96,44,91,15,76,2
09-09-2023,Honeycomb,2,993,978,845,785,60,93,84,16,13,3,1
09-10-2021,CelestialInterface,1,538,237,20,14,6,65,55,29,3,26,1
09-10-2021,PrimeSeven,2,965,325,218,11,207,83,43,36,29,7,4
09-10-2021,Discovery,3,777,532,277,113,164,95,14,47,19,28,2
09-10-2021,BitterLaser,1,843,579,259,232,27,53,21,29,14,15,2
09-10-2021,Discovery,3,606,408,51,39,12,79,48,78,20,58,9
09-10-2021,Mustangs,2,345,246,289,3,286,93,31,14,13,1,0
09-10-2021,Mustangs,1,668,605,229,217,12,73,65,12,8,4,0
09-10-2021,ImpactTraining,2,240,219,15,4,11,74,56,53,3,50,5
09-10-2021,Mustangs,1,916,269,69,51,18,78,43,1,0,1,0
09-10-2022,GrayPanthers,3,585,477,297,109,188,90,74,40,14,26,5
09-10-2022,PrimeSeven,3,203,126,101,13,88,50,23,48,38,10,3
09-10-2022,Mustangs,3,786,603,612,149,463,91,0,34,1,33,3
09-10-2022,CelestialInterface,2,123,14,108,85,23,64,27,23,21,2,0
09-10-2022,Quicksilver,1,107,1,73,28,45,91,34,64,31,33,0
09-10-2022,Quicksilver,3,912,517,767,29,738,50,8,13,9,4,0
09-10-2022,ImpactTraining,2,644,354,41,19,22,87,26,17,11,6,1
09-10-2022,Honeycomb,2,397,186,268,176,92,98,69,1,0,1,0
09-10-2023,GrayPanthers,3,856,100,93,31,62,64,20,51,47,4,5
09-10-2023,Honeycomb,1,155,67,132,98,34,74,56,14,7,7,0
09-10-2023,PrimeSeven,3,176,170,82,5,77,62,6,38,0,38,0
09-10-2023,BitterLaser,3,596,424,405,138,267,73,51,23,18,5,0
09-10-2023,ImpactTraining,1,522,418,359,42,317,56,50,33,25,8,0
09-10-2023,GrayPanthers,1,780,95,652,87,565,80,17,12,2,10,0
09-11-2021,Aurora,3,270,174,239,221,18,50,5,32,31,1,0
09-11-2021,GrayPanthers,2,386,207,230,192,38,84,18,29,2,27,2
09-11-2021,CelestialInterface,3,818,438,567,163,404,68,29,15,9,6,1
09-11-2021,Quicksilver,3,737,650,403,157,246,70,66,6,0,6,0
09-11-2021,Discovery,2,263,15,100,78,22,61,52,22,8,14,1
09-11-2021,BitterLaser,1,649,461,582,343,239,93,16,35,26,9,0
09-11-2021,ImpactTraining,1,580,440,548,71,477,94,38,35,24,11,0
09-11-2021,CelestialInterface,2,482,68,465,37,428,81,5,49,12,37,5
09-11-2022,Mustangs,2,324,126,181,36,145,65,25,2,1,1,0
09-11-2022,Discovery,3,125,27,118,65,53,93,37,39,3,36,0
09-11-2022,ImpactTraining,3,874,760,299,169,130,51,14,43,25,18,4
09-11-2022,GrayPanthers,3,581,419,417,278,139,80,40,70,37,33,5
09-11-2022,GrayPanthers,1,134,71,75,18,57,96,51,79,74,5,9
09-11-2022,Quicksilver,2,523,497,141,133,8,63,41,17,11,6,0
09-11-2022,CelestialInterface,2,143,79,77,53,24,95,51,57,56,1,2
09-11-2022,Honeycomb,3,819,188,272,31,241,67,51,49,35,14,4
09-11-2022,Discovery,3,641,522,256,167,89,69,31,46,39,7,5
09-11-2022,Honeycomb,3,604,118,334,152,182,78,57,21,14,7,2
09-11-2023,GrayPanthers,2,952,268,672,466,206,71,40,12,6,6,0
09-11-2023,Quicksilver,1,240,179,76,7,69,81,26,0,0,0,0
09-11-2023,PrimeSeven,2,257,135,36,4,32,65,16,50,27,23,3
09-11-2023,Aurora,1,269,167,225,170,55,89,4,8,5,3,0
09-11-2023,Mustangs,2,916,217,883,837,46,95,35,69,19,50,9
09-11-2023,Aurora,2,204,97,43,23,20,51,11,6,1,5,0
09-11-2023,Aurora,2,327,238,305,138,167,86,61,56,11,45,2
09-11-2023,Mustangs,1,973,202,428,377,51,80,44,16,14,2,0
09-11-2023,ImpactTraining,3,651,10,570,165,405,66,2,31,12,19,2
09-11-2023,ImpactTraining,3,655,233,146,136,10,64,41,35,4,31,4
09-11-2023,ImpactTraining,3,776,529,262,149,113,100,5,14,11,3,0
09-12-2021,Mustangs,1,995,710,224,195,29,64,51,50,47,3,3
09-12-2021,Discovery,2,692,249,690,171,519,95,94,14,6,8,0
09-12-2021,CelestialInterface,1,745,349,724,506,218,82,15,71,33,38,0
09-12-2021,BitterLaser,2,926,470,763,459,304,80,7,22,21,1,0
09-12-2021,Mustangs,1,806,252,58,9,49,84,70,66,12,54,4
09-12-2021,Discovery,1,488,33,421,81,340,75,29,22,13,9,2
09-12-2021,BitterLaser,3,311,59,36,10,26,53,8,2,0,2,0
09-12-2021,Quicksilver,1,148,30,117,52,65,68,9,23,4,19,1
09-12-2021,Discovery,1,278,104,93,44,49,82,29,43,10,33,3
09-12-2021,CelestialInterface,3,904,847,179,49,130,72,2,14,11,3,1
09-12-2021,ImpactTraining,1,708,652,161,139,22,71,60,25,21,4,1
09-12-2022,Honeycomb,1,219,165,164,26,138,54,14,17,13,4,0
09-12-2022,PrimeSeven,3,901,432,482,12,470,87,8,53,30,23,0
09-12-2022,ImpactTraining,1,679,595,358,47,311,50,1,1,0,1,0
09-12-2022,Discovery,1,446,357,213,209,4,98,92,44,11,33,3
09-12-2022,ImpactTraining,3,382,81,172,165,7,76,3,75,50,25,0
09-12-2022,Mustangs,2,765,713,271,130,141,66,54,3,2,1,0
09-12-2022,PrimeSeven,2,321,210,299,291,8,96,80,43,39,4,4
09-12-2022,GrayPanthers,3,325,170,40,31,9,72,37,69,25,44,1
09-12-2022,Quicksilver,1,358,167,134,120,14,80,65,70,66,4,7
09-12-2022,Honeycomb,1,123,111,43,40,3,51,29,21,6,15,1
09-12-2022,Discovery,2,942,896,488,331,157,88,26,65,55,10,6
09-12-2022,PrimeSeven,2,827,497,19,14,5,82,70,9,1,8,0
09-12-2022,Discovery,2,879,712,204,8,196,55,43,8,4,4,0
09-12-2023,Quicksilver,3,471,99,346,227,119,55,38,12,7,5,0
09-12-2023,Honeycomb,2,666,13,494,437,57,98,40,0,0,0,0
09-12-2023,BitterLaser,1,672,13,642,594,48,54,51,26,7,19,2
09-12-2023,Aurora,1,711,130,587,574,13,69,17,45,4,41,1
09-12-2023,PrimeSeven,1,367,201,196,114,82,89,65,12,10,2,0
09-12-2023,Aurora,1,852,320,341,74,267,96,63,70,25,45,7
09-12-2023,BitterLaser,2,496,394,139,37,102,72,1,48,24,24,0
09-12-2023,CelestialInterface,2,713,281,271,62,209,50,40,36,23,13,3
10-01-2021,GrayPanthers,2,291,192,41,12,29,54,40,38,13,25,4
10-01-2021,GrayPanthers,1,568,24,509,83,426,50,9,40,39,1,3
10-01-2021,CelestialInterface,1,544,152,485,293,192,50,8,27,7,20,0
10-01-2021,Quicksilver,1,655,30,170,165,5,62,51,9,1,8,0
10-01-2021,Quicksilver,2,462,277,21,1,20,89,80,55,27,28,3
10-01-2021,Aurora,2,823,465,63,56,7,100,64,88,58,30,7
10-01-2021,GrayPanthers,2,653,157,275,57,218,99,59,53,30,23,0
10-01-2021,BitterLaser,3,559,122,174,64,110,59,56,42,36,6,2
10-01-2021,GrayPanthers,3,174,15,102,37,65,75,20,28,21,7,1
10-01-2021,Mustangs,2,253,238,158,96,62,98,52,40,12,28,1
10-01-2022,Mustangs,2,565,244,59,14,45,69,43,15,2,13,1
10-01-2022,GrayPanthers,2,898,478,665,405,260,90,11,7,0,7,0
10-01-2022,PrimeSeven,3,390,68,94,91,3,80,57,53,49,4,6
10-01-2022,PrimeSeven,2,508,502,422,81,341,100,96,35,22,13,3
10-01-2022,Discovery,3,228,191,5,0,5,94,36,66,46,20,1
10-01-2022,Honeycomb,3,387,7,17,1,16,93,28,72,39,33,0
10-01-2022,BitterLaser,2,807,608,323,207,116,55,45,1,0,1,0
10-01-2022,Quicksilver,3,970,660,168,153,15,82,71,18,15,3,0
10-01-2023,PrimeSeven,2,742,651,328,181,147,100,29,88,76,12,9
10-01-2023,Honeycomb,1,286,278,91,51,40,76,5,5,2,3,0
10-01-2023,CelestialInterface,1,112,15,92,14,78,100,43,52,22,30,1
10-01-2023,ImpactTraining,2,105,67,93,35,58,77,58,36,21,15,1
10-01-2023,Mustangs,3,239,10,183,65,118,83,28,26,12,14,0
10-01-2023,ImpactTraining,2,505,272,314,68,246,51,31,4,2,2,0
10-01-2023,PrimeSeven,1,179,168,149,65,84,73,41,20,16,4,0
10-01-2023,ImpactTraining,1,170,23,2,0,2,52,33,4,1,3,0
10-01-2023,GrayPanthers,1,778,14,252,235,17,77,54,21,16,5,2
10-02-2021,ImpactTraining,2,299,258,263,184,79,79,53,1,0,1,0
10-02-2021,Aurora,1,819,651,701,339,362,81,60,52,41,11,6
10-02-2021,Honeycomb,1,540,425,534,501,33,55,13,53,1,52,4
10-02-2021,ImpactTraining,1,898,623,55,8,47,84,73,40,9,31,3
10-02-2021,Mustangs,2,446,190,85,73,12,55,41,36,15,21,4
10-02-2021,PrimeSeven,1,827,45,199,139,60,68,41,28,18,10,0
10-02-2021,Mustangs,3,906,46,484,121,363,89,80,53,13,40,5
10-02-2021,Discovery,3,173,1,83,53,30,57,5,34,24,10,3
10-02-2021,BitterLaser,2,627,251,413,245,168,76,37,29,16,13,3
10-02-2021,ImpactTraining,1,867,420,360,141,219,82,74,15,0,15,1
10-02-2022,GrayPanthers,3,816,659,41,27,14,54,13,42,28,14,0
10-02-2022,BitterLaser,2,512,403,254,23,231,77,17,66,14,52,8
10-02-2022,BitterLaser,2,362,112,283,198,85,88,18,78,0,78,6
10-02-2022,Honeycomb,2,865,584,235,42,193,76,42,31,17,14,0
10-02-2022,Mustangs,2,751,372,20,8,12,86,4,24,19,5,2
10-02-2022,PrimeSeven,2,532,460,168,157,11,75,41,37,28,9,4
10-02-2022,Quicksilver,3,715,341,101,0,101,95,57,73,44,29,7
10-02-2022,CelestialInterface,1,559,250,487,388,99,82,61,71,67,4,2
10-02-2022,PrimeSeven,3,211,97,104,81,23,92,21,8,2,6,0
10-02-2022,Mustangs,1,999,93,954,849,105,93,60,18,13,5,0
10-02-2022,Discovery,3,403,321,77,12,65,74,2,53,31,22,0
10-02-2023,GrayPanthers,3,365,313,298,271,27,84,33,2,0,2,0
10-02-2023,GrayPanthers,1,208,134,132,69,63,64,18,51,41,10,6
10-02-2023,Mustangs,2,177,3,160,2,158,84,79,65,52,13,6
10-02-2023,Honeycomb,1,292,30,132,5,127,56,9,37,16,21,2
10-02-2023,Aurora,1,876,795,448,327,121,75,45,7,3,4,0
10-02-2023,Quicksilver,3,359,150,198,98,100,55,50,33,9,24,1
10-02-2023,Honeycomb,1,191,35,57,38,19,79,8,46,5,41,2
10-02-2023,BitterLaser,2,461,295,44,39,5,78,12,0,0,0,0
10-02-2023,Quicksilver,2,180,55,24,4,20,76,36,52,5,47,1
10-02-2023,BitterLaser,1,945,229,139,118,21,74,62,37,15,22,3
10-03-2021,Discovery,1,335,81,3,2,1,88,75,29,17,12,0
10-03-2021,GrayPanthers,2,138,13,9,2,7,75,60,48,15,33,0
10-03-2021,CelestialInterface,1,107,3,98,77,21,61,22,38,10,28,1
10-03-2021,Aurora,3,260,77,215,22,193,59,10,58,52,6,2
10-03-2021,GrayPanthers,3,546,39,212,197,15,71,58,30,23,7,1
10-03-2021,GrayPanthers,2,887,472,523,304,219,84,26,49,47,2,0
10-03-2021,Mustangs,2,169,60,5,4,1,57,10,47,45,2,3
10-03-2022,Mustangs,2,880,379,865,318,547,96,18,28,10,18,0
10-03-2022,Discovery,3,719,148,87,4,83,59,46,23,16,7,0
10-03-2022,Honeycomb,2,852,542,738,242,496,57,53,42,34,8,2
10-03-2022,GrayPanthers,3,688,294,220,176,44,79,41,8,3,5,0
10-03-2022,Honeycomb,1,416,230,226,147,79,53,27,45,17,28,3
10-03-2022,CelestialInterface,1,625,360,181,33,148,74,69,25,23,2,0
10-03-2022,Honeycomb,3,819,794,134,98,36,51,28,34,29,5,3
10-03-2022,BitterLaser,1,789,426,392,259,133,50,12,37,24,13,3
10-03-2023,Honeycomb,2,875,242,453,245,208,60,15,17,0,17,0
10-03-2023,CelestialInterface,1,632,278,316,1,315,99,93,51,3,48,5
10-03-2023,CelestialInterface,2,603,447,418,365,53,93,30,85,7,78,3
10-03-2023,Mustangs,1,224,64,189,18,171,79,48,74,19,55,5
10-03-2023,PrimeSeven,1,175,157,68,44,24,75,5,62,29,33,7
10-03-2023,Discovery,2,754,201,50,9,41,60,37,58,42,16,0
10-03-2023,GrayPanthers,3,816,125,709,536,173,91,16,26,6,20,0
10-03-2023,BitterLaser,2,975,521,845,689,156,52,29,44,3,41,0
10-03-2023,Discovery,2,198,4,58,29,29,74,42,16,13,3,0
10-04-2021,Discovery,2,627,203,453,390,63,97,30,18,16,2,0
10-04-2021,Honeycomb,3,662,558,279,30,249,71,35,20,1,19,2
10-04-2021,Honeycomb,1,602,340,397,31,366,52,18,48,29,19,0
10-04-2021,Discovery,1,252,110,200,31,169,98,20,37,15,22,0
10-04-2021,Mustangs,1,379,108,218,191,27,79,78,76,69,7,10
10-04-2021,ImpactTraining,2,985,560,838,194,644,76,30,29,0,29,1
10-04-2021,Discovery,3,536,373,433,349,84,63,27,6,1,5,0
10-04-2021,Quicksilver,2,465,199,60,14,46,68,46,29,28,1,0
10-04-2021,Honeycomb,1,472,452,195,64,131,68,2,37,9,28,2
10-04-2022,Aurora,3,584,232,520,182,338,79,45,10,9,1,0
10-04-2022,BitterLaser,1,171,19,57,3,54,100,18,69,31,38,0
10-04-2022,PrimeSeven,1,820,469,405,340,65,56,36,37,34,3,2
10-04-2022,Discovery,2,115,103,99,48,51,51,1,45,28,17,4
10-04-2022,Quicksilver,1,580,450,307,240,67,89,33,57,44,13,5
10-04-2023,GrayPanthers,3,640,458,232,54,178,77,21,49,41,8,3
10-04-2023,GrayPanthers,1,159,121,139,66,73,51,11,19,17,2,0
10-04-2023,CelestialInterface,3,847,668,431,352,79,56,44,43,3,40,0
10-04-2023,BitterLaser,3,666,609,211,114,97,72,1,7,1,6,0
10-05-2021,ImpactTraining,3,126,58,66,59,7,85,53,61,33,28,1
10-05-2021,BitterLaser,3,202,13,23,15,8,67,35,21,18,3,1
10-05-2021,ImpactTraining,2,941,46,307,147,160,55,1,35,33,2,3
10-05-2021,PrimeSeven,3,786,172,348,288,60,96,67,94,0,94,11
10-05-2021,BitterLaser,2,194,4,4,2,2,94,28,63,40,23,6
10-05-2021,ImpactTraining,1,188,161,84,5,79,75,35,40,36,4,1
10-05-2021,Quicksilver,2,283,101,217,132,85,79,7,74,67,7,5
10-05-2021,BitterLaser,2,253,141,115,92,23,87,76,82,59,23,10
10-05-2021,Discovery,3,623,560,238,28,210,59,19,44,34,10,4
10-05-2021,Mustangs,2,554,498,450,342,108,56,32,49,31,18,4
10-05-2021,Quicksilver,3,508,264,207,150,57,85,77,0,0,0,0
10-05-2022,ImpactTraining,3,199,196,65,54,11,50,5,16,2,14,0
10-05-2022,PrimeSeven,2,558,155,1,0,1,100,80,24,23,1,1
10-05-2022,Mustangs,3,987,721,369,172,197,82,76,45,0,45,0
10-05-2022,Aurora,2,795,273,772,129,643,52,7,16,1,15,1
10-05-2022,CelestialInterface,2,493,453,408,305,103,93,83,0,0,0,0
10-05-2022,Honeycomb,2,450,368,408,232,176,73,68,45,3,42,5
10-05-2022,GrayPanthers,1,302,20,218,167,51,81,66,30,15,15,3
10-05-2022,Mustangs,1,229,158,189,8,181,89,33,39,4,35,1
10-05-2022,PrimeSeven,1,847,528,778,63,715,88,50,12,6,6,0
10-05-2022,Honeycomb,1,525,11,83,39,44,88,62,11,8,3,0
10-05-2022,PrimeSeven,1,573,545,393,356,37,56,20,18,9,9,0
10-05-2022,Honeycomb,2,683,679,120,90,30,80,28,39,38,1,2
10-05-2022,CelestialInterface,1,657,156,227,225,2,67,53,32,19,13,0
10-05-2022,GrayPanthers,3,130,114,45,36,9,88,50,56,18,38,4
10-05-2023,Quicksilver,2,360,201,166,130,36,69,51,8,0,8,0
10-05-2023,PrimeSeven,2,694,603,37,36,1,70,29,41,26,15,3
10-05-2023,ImpactTraining,1,187,35,32,11,21,66,3,43,28,15,4
10-05-2023,Aurora,1,843,22,569,36,533,89,48,44,14,30,2
10-05-2023,PrimeSeven,2,960,476,406,241,165,61,56,18,17,1,1
10-05-2023,PrimeSeven,3,426,339,273,206,67,59,36,13,2,11,0
10-05-2023,Honeycomb,1,141,123,101,14,87,66,40,38,33,5,0
10-06-2021,BitterLaser,1,221,81,213,89,124,62,26,5,0,5,0
10-06-2021,GrayPanthers,1,316,272,148,69,79,66,0,9,6,3,0
10-06-2021,PrimeSeven,2,136,4,15,4,11,86,85,63,57,6,8
10-06-2021,ImpactTraining,2,881,46,862,574,288,79,4,58,14,44,0
10-06-2021,Discovery,2,441,103,314,239,75,75,22,73,47,26,8
10-06-2021,PrimeSeven,3,467,107,363,80,283,94,84,15,10,5,1
10-06-2021,GrayPanthers,3,234,163,62,12,50,61,28,53,27,26,4
10-06-2021,Mustangs,3,320,283,84,28,56,86,43,80,70,10,2
10-06-2021,Quicksilver,1,845,142,141,13,128,90,57,71,38,33,4
10-06-2021,CelestialInterface,3,474,304,139,58,81,74,48,65,25,40,1
10-06-2021,Mustangs,2,556,428,194,152,42,99,26,44,9,35,3
10-06-2021,GrayPanthers,3,930,619,473,420,53,100,48,27,23,4,3
10-06-2022,Aurora,3,826,575,79,77,2,98,68,46,2,44,0
10-06-2022,ImpactTraining,3,770,217,396,332,64,58,45,5,1,4,0
10-06-2022,CelestialInterface,1,107,84,15,10,5,83,7,60,36,24,4
10-06-2022,Quicksilver,3,655,146,20,0,20,76,32,51,2,49,5
10-06-2022,PrimeSeven,1,902,559,473,135,338,80,67,41,12,29,3
10-06-2022,Honeycomb,3,971,260,909,215,694,65,16,52,4,48,0
10-06-2022,CelestialInterface,1,830,439,759,134,625,90,49,85,17,68,3
10-06-2022,Honeycomb,3,159,62,78,7,71,54,48,53,11,42,4
10-06-2022,BitterLaser,1,777,481,749,174,575,52,19,43,24,19,2
10-06-2022,ImpactTraining,2,535,511,206,186,20,86,33,22,21,1,0
10-06-2022,ImpactTraining,3,842,100,675,151,524,54,39,47,31,16,5
10-06-2022,GrayPanthers,2,133,35,62,32,30,99,51,18,16,2,1
10-06-2022,Quicksilver,1,762,211,719,589,130,59,52,20,17,3,0
10-06-2022,Aurora,1,213,204,31,19,12,96,34,26,9,17,2
10-06-2022,PrimeSeven,3,728,542,695,661,34,85,43,19,6,13,1
10-06-2023,ImpactTraining,3,786,136,11,1,10,86,74,15,5,10,0
10-06-2023,Discovery,1,700,609,149,102,47,72,47,49,8,41,5
10-06-2023,Mustangs,1,372,214,206,62,144,55,50,50,14,36,1
10-06-2023,CelestialInterface,1,769,599,644,371,273,87,41,21,1,20,1
10-06-2023,Honeycomb,1,163,4,29,17,12,55,53,4,3,1,0
10-06-2023,Honeycomb,1,747,684,515,510,5,57,47,48,47,1,3
10-06-2023,ImpactTraining,2,395,143,393,346,47,68,0,35,18,17,2
10-06-2023,Discovery,1,141,1,117,57,60,78,70,69,29,40,2
10-06-2023,Honeycomb,1,909,270,25,4,21,83,5,34,21,13,1
10-07-2021,Quicksilver,3,269,205,214,124,90,92,72,13,4,9,0
10-07-2021,Aurora,3,294,62,4,2,2,80,29,5,3,2,0
10-07-2021,Discovery,2,107,44,34,5,29,65,24,28,14,14,0
10-07-2021,Discovery,3,166,21,107,8,99,94,40,2,0,2,0
10-07-2021,GrayPanthers,1,857,253,223,194,29,70,56,35,7,28,1
10-07-2021,ImpactTraining,3,667,80,530,430,100,63,40,26,10,16,1
10-07-2022,CelestialInterface,1,387,79,98,41,57,54,19,27,25,2,1
10-07-2022,Discovery,3,591,452,369,339,30,64,42,42,17,25,3
10-07-2022,PrimeSeven,3,998,668,240,189,51,66,21,26,18,8,0
10-07-2022,Aurora,2,944,391,273,199,74,100,79,95,32,63,6
10-07-2022,CelestialInterface,2,927,841,5,4,1,54,14,12,6,6,0
10-07-2022,Aurora,1,923,171,726,725,1,78,10,17,2,15,1
10-07-2022,Aurora,2,605,477,439,204,235,69,36,58,57,1,5
10-07-2022,Honeycomb,1,125,65,112,84,28,61,41,11,10,1,0
10-07-2022,ImpactTraining,2,518,199,232,125,107,92,88,62,47,15,8
10-07-2022,GrayPanthers,2,160,53,100,94,6,98,23,26,12,14,0
10-07-2022,GrayPanthers,3,536,463,40,37,3,94,86,78,38,40,10
10-07-2022,PrimeSeven,1,472,49,334,64,270,68,33,34,1,33,3
10-07-2022,Quicksilver,3,723,246,555,168,387,83,50,24,13,11,2
10-07-2022,PrimeSeven,3,225,138,127,22,105,93,5,77,68,9,9
10-07-2023,CelestialInterface,2,380,160,235,41,194,91,30,73,3,70,2
10-07-2023,PrimeSeven,2,132,85,127,2,125,78,50,27,13,14,3
10-07-2023,Honeycomb,3,823,372,302,217,85,100,37,41,38,3,5
10-08-2021,GrayPanthers,2,928,510,26,3,23,61,49,11,1,10,0
10-08-2021,CelestialInterface,2,928,881,415,248,167,88,6,44,19,25,1
10-08-2021,CelestialInterface,1,120,102,37,13,24,91,20,11,3,8,0
10-08-2021,PrimeSeven,2,804,659,283,35,248,82,71,23,15,8,1
10-08-2021,CelestialInterface,1,135,52,84,71,13,76,64,45,6,39,0
10-08-2021,Quicksilver,3,452,112,363,96,267,63,24,22,7,15,1
10-08-2021,Aurora,3,937,116,468,465,3,61,59,20,18,2,1
10-08-2021,Quicksilver,1,848,497,269,252,17,83,42,77,59,18,6
10-08-2021,Quicksilver,3,666,583,637,398,239,79,30,40,17,23,3
10-08-2021,PrimeSeven,1,834,582,439,174,265,77,13,29,4,25,1
10-08-2021,Quicksilver,1,104,97,17,9,8,53,16,35,9,26,0
10-08-2021,Aurora,3,851,414,735,48,687,93,89,72,33,39,7
10-08-2022,BitterLaser,1,962,222,858,747,111,91,72,6,1,5,0
10-08-2022,Quicksilver,1,156,37,109,103,6,73,63,4,2,2,0
10-08-2022,GrayPanthers,1,470,85,172,76,96,69,33,25,11,14,2
10-08-2022,Mustangs,3,355,269,291,57,234,82,17,29,6,23,2
10-08-2022,Honeycomb,2,297,255,285,47,238,59,57,35,10,25,3
10-08-2022,BitterLaser,3,268,111,124,79,45,76,12,61,39,22,3
10-08-2022,Quicksilver,1,945,588,472,315,157,86,45,18,15,3,1
10-08-2022,Discovery,2,712,701,223,181,42,72,13,55,44,11,1
10-08-2023,Honeycomb,2,198,155,109,85,24,93,0,35,16,19,4
10-08-2023,Discovery,2,412,50,88,78,10,100,21,79,34,45,2
10-08-2023,CelestialInterface,2,448,270,307,292,15,79,49,15,3,12,0
10-08-2023,Quicksilver,2,907,215,95,34,61,83,26,30,2,28,3
10-08-2023,BitterLaser,2,514,438,69,48,21,61,35,8,4,4,0
10-08-2023,Quicksilver,3,650,471,63,62,1,57,8,45,34,11,2
10-08-2023,Mustangs,3,492,368,152,32,120,76,53,58,20,38,5
10-08-2023,Mustangs,1,857,125,391,148,243,54,38,43,17,26,0
10-08-2023,BitterLaser,3,954,422,391,151,240,84,6,15,3,12,0
10-08-2023,Discovery,1,309,40,259,120,139,62,33,52,23,29,0
10-09-2021,Mustangs,1,820,800,245,1,244,50,14,27,2,25,3
10-09-2021,Quicksilver,1,541,447,534,265,269,89,0,32,4,28,1
10-09-2021,ImpactTraining,2,348,157,228,212,16,71,67,38,25,13,0
10-09-2021,Quicksilver,2,366,148,311,173,138,99,75,62,51,11,1
10-09-2021,Honeycomb,2,934,836,880,80,800,79,44,39,27,12,0
10-09-2021,PrimeSeven,3,518,125,236,26,210,97,27,83,7,76,5
10-09-2021,BitterLaser,2,956,552,597,532,65,51,2,13,8,5,0
10-09-2021,Aurora,1,878,436,372,339,33,83,46,71,8,63,9
10-09-2021,GrayPanthers,2,261,155,204,24,180,76,60,63,18,45,8
10-09-2022,Honeycomb,1,876,204,140,58,82,69,36,27,4,23,0
10-09-2022,Aurora,1,939,872,438,357,81,55,21,21,2,19,0
10-09-2022,Mustangs,1,274,208,268,144,124,51,50,28,19,9,1
10-09-2022,Honeycomb,1,876,702,123,87,36,74,6,29,26,3,1
10-09-2022,CelestialInterface,1,572,451,59,13,46,91,61,4,3,1,0
10-09-2022,CelestialInterface,2,980,583,751,609,142,71,68,70,10,60,4
10-09-2022,PrimeSeven,1,920,755,909,811,98,65,28,32,21,11,2
10-09-2022,Aurora,3,198,162,109,54,55,94,9,30,28,2,1
10-09-2022,Aurora,1,685,46,111,2,109,74,36,8,4,4,0
10-09-2022,ImpactTraining,1,126,28,105,30,75,79,44,32,8,24,2
10-09-2022,Aurora,3,488,447,393,35,358,66,39,41,16,25,1
10-09-2022,GrayPanthers,1,682,309,174,148,26,97,62,54,30,24,7
10-09-2022,Discovery,3,872,127,840,642,198,89,70,63,50,13,3
10-09-2022,Mustangs,1,910,396,390,230,160,91,33,37,22,15,2
10-09-2023,ImpactTraining,2,896,479,644,89,555,77,38,4,0,4,0
10-09-2023,Discovery,3,434,405,57,36,21,84,68,2,1,1,0
10-09-2023,CelestialInterface,2,264,185,199,153,46,63,11,61,17,44,1
10-09-2023,Honeycomb,3,978,275,768,479,289,55,9,39,2,37,0
10-09-2023,Mustangs,2,632,22,15,12,3,73,59,67,22,45,6
10-09-2023,Quicksilver,1,825,4,720,711,9,53,25,1,0,1,0
10-09-2023,CelestialInterface,2,904,878,789,164,625,76,18,4,2,2,0
10-09-2023,BitterLaser,3,259,204,219,24,195,98,17,1,0,1,0
10-09-2023,GrayPanthers,3,789,322,782,327,455,54,6,21,17,4,1
10-09-2023,Honeycomb,1,102,83,28,25,3,60,51,25,1,24,2
10-10-2021,Honeycomb,1,354,71,210,64,146,50,5,16,1,15,1
10-10-2021,ImpactTraining,2,477,452,111,88,23,62,45,31,20,11,3
10-10-2021,BitterLaser,2,257,144,179,89,90,72,4,23,6,17,0
10-10-2021,Mustangs,1,611,197,596,547,49,99,66,15,10,5,1
10-10-2021,Honeycomb,2,694,462,535,447,88,93,60,58,23,35,1
10-10-2021,Discovery,3,671,353,36,24,12,55,5,50,2,48,4
10-10-2021,Honeycomb,1,522,50,294,176,118,98,45,97,2,95,9
10-10-2021,Aurora,2,869,854,261,14,247,68,43,25,17,8,0
10-10-2021,PrimeSeven,1,600,279,428,271,157,79,75,38,5,33,2
10-10-2022,Honeycomb,2,631,76,155,106,49,64,14,54,14,40,2
10-10-2022,Mustangs,2,584,523,73,10,63,54,30,1,0,1,0
10-10-2022,Mustangs,2,792,626,254,204,50,97,90,51,13,38,4
10-10-2022,Aurora,3,809,73,112,90,22,75,10,72,36,36,7
10-10-2022,PrimeSeven,2,487,302,13,6,7,59,52,55,32,23,2
10-10-2023,Aurora,2,877,821,206,11,195,79,71,19,12,7,0
10-10-2023,Discovery,2,517,73,482,118,364,71,45,16,4,12,1
10-10-2023,Honeycomb,3,233,60,111,72,39,55,36,9,7,2,0
10-10-2023,GrayPanthers,2,553,392,2,0,2,63,5,9,4,5,0
10-10-2023,BitterLaser,1,616,382,38,12,26,54,2,45,8,37,3
10-10-2023,Honeycomb,2,402,88,132,73,59,83,72,36,12,24,2
10-10-2023,BitterLaser,1,442,100,336,221,115,62,23,25,17,8,0
10-10-2023,CelestialInterface,2,318,76,10,5,5,93,76,45,39,6,0
10-11-2021,Honeycomb,1,946,272,679,263,416,87,32,65,39,26,3
10-11-2021,Discovery,2,641,41,298,133,165,65,43,63,30,33,1
10-11-2021,Discovery,3,302,149,111,73,38,62,9,7,5,2,0
10-11-2021,Aurora,2,709,2,255,167,88,89,7,21,15,6,2
10-11-2022,BitterLaser,2,342,178,62,8,54,66,65,32,11,21,2
10-11-2022,PrimeSeven,2,310,262,195,174,21,95,49,55,0,55,1
10-11-2022,Quicksilver,2,544,500,337,128,209,85,26,58,2,56,4
10-11-2022,ImpactTraining,1,796,475,145,130,15,76,36,60,17,43,5
10-11-2022,Quicksilver,3,252,150,100,57,43,97,83,39,16,23,4
10-11-2022,ImpactTraining,1,370,359,114,53,61,73,63,2,0,2,0
10-11-2022,Mustangs,1,268,218,199,68,131,72,67,1,0,1,0
10-11-2022,Discovery,2,117,18,28,16,12,78,72,54,28,26,1
10-11-2022,Mustangs,3,558,543,160,57,103,96,8,93,43,50,10
10-11-2023,Honeycomb,1,214,65,44,11,33,68,16,44,29,15,1
10-11-2023,BitterLaser,1,346,171,185,105,80,97,24,86,5,81,9
10-11-2023,Mustangs,1,762,32,334,203,131,79,66,65,10,55,8
10-11-2023,Discovery,1,431,296,14,9,5,88,14,19,3,16,0
10-11-2023,ImpactTraining,2,977,849,840,418,422,53,2,7,3,4,0
10-11-2023,ImpactTraining,1,623,69,611,495,116,86,73,65,2,63,7
10-12-2021,Quicksilver,3,714,35,616,342,274,57,36,6,2,4,0
10-12-2021,PrimeSeven,1,752,178,280,112,168,81,12,56,49,7,6
10-12-2021,Discovery,1,682,408,525,70,455,89,47,67,39,28,2
10-12-2021,Honeycomb,2,466,359,388,154,234,58,43,14,13,1,0
10-12-2021,Discovery,2,406,238,288,59,229,84,64,77,13,64,5
10-12-2021,ImpactTraining,1,118,90,95,46,49,74,34,61,54,7,8
10-12-2021,Aurora,3,679,628,357,113,244,97,84,83,31,52,8
10-12-2021,BitterLaser,1,307,38,33,12,21,61,33,55,31,24,7
10-12-2021,ImpactTraining,3,312,46,86,60,26,96,1,28,15,13,0
10-12-2021,GrayPanthers,2,688,554,156,88,68,98,18,97,25,72,9
10-12-2021,Honeycomb,1,989,919,219,9,210,72,23,43,35,8,5
10-12-2021,BitterLaser,3,870,833,147,136,11,82,13,50,32,18,5
10-12-2022,BitterLaser,2,374,174,226,18,208,57,47,38,36,2,0
10-12-2022,GrayPanthers,1,559,312,224,96,128,77,17,21,3,18,0
10-12-2022,CelestialInterface,1,647,542,283,251,32,63,19,4,2,2,0
10-12-2022,ImpactTraining,2,562,317,55,49,6,100,40,29,7,22,1
10-12-2022,Discovery,3,231,193,56,50,6,76,47,43,9,34,0
10-12-2022,Discovery,3,465,78,213,92,121,71,11,66,38,28,7
10-12-2022,Discovery,3,812,730,426,98,328,85,32,1,0,1,0
10-12-2022,PrimeSeven,3,829,152,493,120,373,72,18,56,51,5,4
10-12-2022,BitterLaser,3,690,488,350,143,207,99,2,43,24,19,1
10-12-2022,Mustangs,1,773,634,187,110,77,68,54,65,29,36,5
10-12-2022,PrimeSeven,2,582,189,383,295,88,79,42,41,31,10,3
10-12-2023,Quicksilver,1,578,370,125,0,125,72,56,36,24,12,2
10-12-2023,Honeycomb,3,330,171,254,53,201,88,51,46,36,10,1
10-12-2023,Mustangs,2,660,218,43,12,31,68,8,40,35,5,5
10-12-2023,CelestialInterface,1,788,313,292,90,202,52,23,15,2,13,0
10-12-2023,BitterLaser,2,195,27,182,16,166,72,1,43,27,16,4
10-12-2023,Quicksilver,3,562,452,230,195,35,79,48,69,67,2,3
10-12-2023,Aurora,2,179,92,154,109,45,77,9,36,24,12,3
10-12-2023,CelestialInterface,1,294,52,185,153,32,75,30,62,24,38,7
11-01-2021,Honeycomb,2,329,265,296,166,130,57,41,12,9,3,0
11-01-2021,Aurora,2,586,433,87,29,58,70,65,49,39,10,1
11-01-2021,Aurora,3,448,202,305,73,232,54,37,39,6,33,2
11-01-2022,GrayPanthers,2,301,253,178,161,17,90,17,29,2,27,1
11-01-2022,CelestialInterface,2,658,311,411,316,95,50,0,28,17,11,1
11-01-2022,Discovery,3,401,226,76,5,71,62,31,8,7,1,0
11-01-2022,Mustangs,3,725,124,670,158,512,61,31,12,5,7,0
11-01-2022,BitterLaser,1,939,454,662,574,88,81,73,11,5,6,0
11-01-2022,Discovery,3,906,194,456,384,72,57,21,18,10,8,0
11-01-2022,Aurora,2,430,28,143,2,141,82,28,21,8,13,2
11-01-2022,PrimeSeven,3,872,813,844,260,584,92,3,61,47,14,0
11-01-2023,GrayPanthers,1,438,347,330,214,116,100,91,42,24,18,0
11-01-2023,Honeycomb,1,247,161,82,56,26,72,7,6,5,1,0
11-01-2023,Discovery,1,505,339,169,123,46,66,36,14,9,5,0
11-01-2023,ImpactTraining,2,799,342,416,380,36,91,29,36,28,8,0
11-01-2023,CelestialInterface,1,327,87,178,149,29,57,12,46,38,8,2
11-01-2023,Mustangs,3,884,862,823,440,383,91,88,64,11,53,5
11-01-2023,PrimeSeven,2,789,57,744,692,52,53,8,13,1,12,0
11-01-2023,Quicksilver,1,213,76,64,27,37,62,7,45,36,9,1
11-01-2023,Aurora,1,538,434,345,301,44,93,40,57,46,11,3
11-01-2023,Aurora,3,171,162,153,27,126,72,70,62,35,27,0
11-01-2023,Mustangs,3,670,118,356,52,304,65,37,31,5,26,0
11-02-2021,Mustangs,3,828,680,202,160,42,50,13,9,2,7,0
11-02-2021,Honeycomb,2,609,16,509,446,63,80,63,68,11,57,8
11-02-2021,Honeycomb,1,896,691,538,529,9,97,34,53,10,43,2
11-02-2021,Aurora,2,885,876,513,53,460,80,2,34,14,20,1
11-02-2021,Mustangs,1,771,387,444,113,331,100,70,23,11,12,2
11-02-2021,Discovery,3,738,340,263,66,197,95,73,89,44,45,8
11-02-2022,PrimeSeven,2,906,205,150,127,23,56,49,25,1,24,1
11-02-2022,CelestialInterface,3,245,4,158,149,9,78,77,70,16,54,4
11-02-2022,Discovery,3,995,357,36,19,17,87,32,82,44,38,4
11-02-2022,PrimeSeven,3,528,130,405,147,258,50,30,0,0,0,0
11-02-2022,CelestialInterface,2,211,15,64,40,24,98,69,54,40,14,3
11-02-2022,Discovery,1,741,265,138,40,98,89,10,60,29,31,2
11-02-2022,Quicksilver,1,775,544,106,72,34,94,67,5,4,1,0
11-02-2022,CelestialInterface,1,658,502,368,53,315,84,32,35,9,26,1
11-02-2022,PrimeSeven,1,469,317,140,4,136,54,1,8,7,1,0
11-02-2022,Quicksilver,2,397,273,281,236,45,69,8,52,33,19,0
11-02-2022,Honeycomb,1,434,230,320,206,114,64,21,29,28,1,1
11-02-2022,Quicksilver,2,628,95,444,190,254,95,4,70,32,38,4
11-02-2022,ImpactTraining,1,180,73,149,1,148,66,56,0,0,0,0
11-02-2022,Honeycomb,1,253,44,219,153,66,69,38,9,8,1,0
11-02-2023,Mustangs,3,579,516,40,3,37,54,6,47,42,5,1
11-02-2023,GrayPanthers,3,581,418,462,426,36,58,18,53,26,27,4
11-02-2023,GrayPanthers,3,544,494,482,386,96,55,22,30,7,23,3
11-02-2023,CelestialInterface,2,682,130,189,179,10,97,60,51,12,39,6
11-02-2023,Discovery,1,134,105,130,10,120,69,59,67,43,24,1
11-02-2023,BitterLaser,3,742,637,532,394,138,89,4,78,11,67,0
11-02-2023,PrimeSeven,1,416,195,223,14,209,87,33,86,76,10,3
11-02-2023,Quicksilver,3,571,165,122,4,118,56,28,11,9,2,0
11-02-2023,Honeycomb,3,884,189,811,688,123,84,58,12,8,4,0
11-02-2023,CelestialInterface,1,908,684,176,81,95,58,38,0,0,0,0
11-02-2023,Quicksilver,3,717,421,458,48,410,57,10,1,0,1,0
11-02-2023,CelestialInterface,3,386,260,233,92,141,85,38,14,0,14,0
11-03-2021,Aurora,1,319,203,42,41,1,97,34,81,41,40,0
11-03-2021,Mustangs,3,341,64,311,244,67,58,28,11,8,3,0
11-03-2021,Mustangs,1,347,322,135,118,17,86,24,68,12,56,4
11-03-2021,BitterLaser,1,650,328,635,509,126,76,60,35,32,3,2
11-03-2021,Honeycomb,1,682,228,407,387,20,69,40,48,27,21,4
11-03-2021,Honeycomb,3,391,309,158,46,112,76,39,46,22,24,4
11-03-2021,Discovery,1,573,500,447,74,373,99,74,27,21,6,3
11-03-2021,GrayPanthers,2,364,150,362,5,357,82,15,22,21,1,2
11-03-2021,CelestialInterface,1,352,245,269,39,230,53,24,24,22,2,0
11-03-2021,CelestialInterface,2,407,153,142,82,60,100,88,86,74,12,4
11-03-2021,PrimeSeven,2,542,529,148,107,41,83,28,57,19,38,1
11-03-2021,Quicksilver,3,180,135,45,16,29,94,54,84,38,46,9
11-03-2022,Quicksilver,1,966,420,767,570,197,50,28,12,1,11,0
11-03-2022,GrayPanthers,1,1000,543,450,163,287,71,16,49,21,28,3
11-03-2022,Mustangs,1,931,312,768,32,736,98,75,0,0,0,0
11-03-2022,ImpactTraining,3,180,7,119,53,66,80,6,18,1,17,1
11-03-2022,CelestialInterface,2,564,440,110,69,41,88,40,31,25,6,3
11-03-2022,ImpactTraining,2,278,170,274,152,122,86,32,44,26,18,5
11-03-2022,Quicksilver,1,191,159,92,70,22,70,64,6,0,6,0
11-03-2022,Honeycomb,2,246,229,17,15,2,66,65,8,1,7,0
11-03-2022,BitterLaser,1,641,261,66,51,15,84,9,73,13,60,4
11-03-2022,BitterLaser,3,563,41,483,146,337,90,22,44,3,41,4
11-03-2022,PrimeSeven,1,630,299,605,312,293,74,61,27,15,12,0
11-03-2022,Discovery,1,681,557,477,170,307,85,11,21,9,12,1
11-03-2023,Discovery,3,354,332,129,8,121,87,37,55,37,18,0
11-03-2023,Discovery,3,795,300,454,5,449,71,37,3,2,1,0
11-03-2023,Honeycomb,2,381,284,295,160,135,79,1,54,47,7,2
11-03-2023,BitterLaser,1,456,196,80,72,8,51,11,22,10,12,0
11-03-2023,Discovery,2,845,251,674,219,455,75,7,25,17,8,0
11-03-2023,Mustangs,1,596,162,331,105,226,50,39,0,0,0,0
11-03-2023,GrayPanthers,3,225,36,181,10,171,100,0,94,66,28,6
11-03-2023,Mustangs,3,493,19,475,241,234,68,46,15,1,14,1
11-03-2023,Mustangs,2,142,118,39,3,36,95,83,14,12,2,1
11-04-2021,ImpactTraining,1,710,510,605,133,472,51,5,30,14,16,1
11-04-2021,Quicksilver,2,322,261,320,37,283,57,10,9,3,6,0
11-04-2021,Aurora,1,426,298,116,96,20,60,3,53,28,25,3
11-04-2021,ImpactTraining,2,321,184,105,18,87,85,9,6,4,2,0
11-04-2021,Honeycomb,3,829,739,352,349,3,91,64,14,6,8,0
11-04-2021,ImpactTraining,2,554,481,486,135,351,54,24,7,3,4,0
11-04-2021,Discovery,3,146,111,65,1,64,61,56,43,21,22,5
11-04-2021,Aurora,2,931,757,742,465,277,96,32,47,46,1,1
11-04-2022,Mustangs,3,752,565,333,140,193,66,20,44,37,7,1
11-04-2022,Discovery,1,653,439,505,231,274,62,52,11,7,4,0
11-04-2022,ImpactTraining,2,726,273,600,461,139,83,30,35,17,18,0
11-04-2022,GrayPanthers,3,801,243,479,151,328,80,33,2,0,2,0
11-04-2022,ImpactTraining,3,445,333,294,51,243,77,19,48,40,8,5
11-04-2022,Quicksilver,3,386,32,328,38,290,87,72,66,52,14,4
11-04-2022,BitterLaser,1,116,57,15,6,9,87,68,45,15,30,1
11-04-2022,CelestialInterface,2,867,246,859,133,726,70,25,28,8,20,0
11-04-2022,CelestialInterface,1,794,556,614,306,308,91,67,64,45,19,8
11-04-2023,ImpactTraining,2,834,321,400,365,35,71,46,48,21,27,6
11-04-2023,Quicksilver,1,952,257,240,18,222,94,92,64,33,31,2
11-04-2023,ImpactTraining,2,937,507,607,595,12,88,5,44,25,19,4
11-04-2023,GrayPanthers,2,958,738,838,621,217,76,69,37,14,23,3
11-04-2023,BitterLaser,1,582,83,48,7,41,84,45,36,33,3,0
11-04-2023,Aurora,1,524,185,156,87,69,71,26,66,61,5,7
11-04-2023,BitterLaser,1,866,366,80,63,17,50,5,13,2,11,0
11-04-2023,Quicksilver,3,641,356,115,12,103,50,14,1,0,1,0
11-04-2023,GrayPanthers,1,321,196,125,36,89,75,23,47,28,19,6
11-05-2021,ImpactTraining,3,312,10,247,131,116,55,19,32,5,27,2
11-05-2021,Quicksilver,2,731,375,272,23,249,78,0,13,4,9,0
11-05-2021,BitterLaser,2,278,164,104,82,22,91,4,37,34,3,2
11-05-2021,Aurora,2,180,40,38,20,18,98,86,93,87,6,11
11-05-2021,Honeycomb,3,825,603,540,143,397,71,37,30,5,25,1
11-05-2021,Quicksilver,1,317,283,186,41,145,84,3,33,31,2,0
11-05-2022,CelestialInterface,2,703,418,487,12,475,56,6,52,27,25,2
11-05-2022,ImpactTraining,1,195,191,6,4,2,55,2,8,6,2,0
11-05-2022,CelestialInterface,2,277,199,211,178,33,90,7,63,52,11,1
11-05-2022,PrimeSeven,1,398,169,120,97,23,100,54,69,1,68,3
11-05-2022,BitterLaser,1,403,179,94,3,91,78,43,52,6,46,5
11-05-2022,CelestialInterface,3,956,918,461,137,324,91,72,69,34,35,8
11-05-2022,Discovery,2,199,27,160,146,14,69,21,64,59,5,7
11-05-2022,Discovery,3,375,253,136,78,58,55,44,35,5,30,2
11-05-2022,Discovery,1,860,75,274,227,47,94,73,62,17,45,2
11-05-2023,Honeycomb,2,681,560,168,93,75,92,69,16,15,1,1
11-05-2023,Honeycomb,2,747,695,735,114,621,73,32,57,53,4,4
11-05-2023,Aurora,2,330,91,27,13,14,77,40,25,18,7,1
11-05-2023,Mustangs,1,421,33,227,140,87,73,7,53,11,42,0
11-05-2023,GrayPanthers,3,202,24,7,1,6,72,4,23,15,8,0
11-05-2023,Honeycomb,2,160,120,49,28,21,72,15,71,38,33,6
11-06-2021,PrimeSeven,2,802,706,151,107,44,85,7,78,18,60,5
11-06-2021,Mustangs,2,709,524,465,39,426,71,51,62,29,33,0
11-06-2021,CelestialInterface,3,989,86,426,363,63,100,68,71,64,7,6
11-06-2021,Mustangs,3,624,157,60,36,24,73,45,56,20,36,4
11-06-2021,BitterLaser,3,481,283,409,91,318,65,14,51,43,8,1
11-06-2021,Aurora,3,816,457,200,99,101,73,16,30,4,26,1
11-06-2021,Discovery,3,412,360,123,61,62,50,42,48,17,31,3
11-06-2022,Aurora,1,330,95,231,72,159,72,44,41,11,30,5
11-06-2022,Quicksilver,2,628,365,450,136,314,83,36,22,8,14,1
11-06-2022,CelestialInterface,2,620,312,426,83,343,86,60,49,9,40,6
11-06-2022,BitterLaser,3,236,154,178,116,62,70,65,13,0,13,0
11-06-2022,CelestialInterface,1,824,314,95,50,45,80,36,71,12,59,1
11-06-2022,Discovery,1,788,319,274,83,191,56,23,32,10,22,3
11-06-2023,PrimeSeven,3,305,293,49,22,27,84,18,46,12,34,5
11-06-2023,Discovery,2,863,717,529,69,460,71,36,23,0,23,1
11-06-2023,Honeycomb,2,408,129,240,12,228,83,79,66,9,57,7
11-06-2023,GrayPanthers,1,253,127,209,149,60,86,36,0,0,0,0
11-07-2021,CelestialInterface,2,854,388,722,660,62,51,43,41,37,4,1
11-07-2021,ImpactTraining,3,714,318,408,120,288,79,31,43,23,20,5
11-07-2021,PrimeSeven,3,734,568,704,409,295,85,34,31,13,18,0
11-07-2021,Honeycomb,3,965,840,317,223,94,82,42,27,4,23,0
11-07-2021,ImpactTraining,1,533,270,8,4,4,77,32,18,15,3,0
11-07-2021,Discovery,1,926,22,660,128,532,86,71,11,0,11,0
11-07-2021,CelestialInterface,2,550,510,496,57,439,80,2,60,29,31,7
11-07-2021,Mustangs,1,244,207,207,12,195,70,41,4,3,1,0
11-07-2022,Honeycomb,2,694,600,295,86,209,99,98,5,2,3,0
11-07-2022,Aurora,1,561,337,441,354,87,57,25,30,4,26,0
11-07-2022,Discovery,3,388,318,21,20,1,79,51,60,31,29,6
11-07-2022,GrayPanthers,3,313,132,31,27,4,60,24,52,37,15,0
11-07-2022,Honeycomb,1,925,443,672,330,342,53,46,49,37,12,2
11-07-2022,CelestialInterface,1,303,38,206,27,179,91,82,22,20,2,0
11-07-2022,ImpactTraining,1,397,15,306,92,214,59,50,9,5,4,0
11-07-2022,Honeycomb,3,158,157,0,0,0,64,19,47,25,22,3
11-07-2022,Aurora,2,483,83,205,105,100,91,84,23,19,4,0
11-07-2022,ImpactTraining,1,130,12,49,36,13,57,14,24,10,14,0
11-07-2023,Honeycomb,3,746,479,455,147,308,83,58,29,26,3,1
11-07-2023,Honeycomb,2,915,265,262,32,230,79,34,67,9,58,3
11-07-2023,PrimeSeven,1,614,451,308,226,82,64,31,18,17,1,0
11-07-2023,Discovery,2,302,281,90,53,37,86,24,12,9,3,0
11-07-2023,Honeycomb,2,103,74,16,5,11,94,61,71,10,61,0
11-07-2023,Quicksilver,3,483,188,402,249,153,95,82,67,9,58,5
11-07-2023,CelestialInterface,3,159,150,62,60,2,69,3,54,20,34,3
11-07-2023,PrimeSeven,1,983,462,287,247,40,76,34,1,0,1,0
11-07-2023,CelestialInterface,1,957,802,495,52,443,86,61,49,0,49,2
11-07-2023,PrimeSeven,1,561,474,441,268,173,74,47,6,3,3,0
11-07-2023,GrayPanthers,2,464,5,207,46,161,72,8,18,12,6,1
11-08-2021,ImpactTraining,2,342,21,281,42,239,97,53,47,41,6,6
11-08-2021,CelestialInterface,2,165,85,125,29,96,91,50,64,21,43,7
11-08-2021,PrimeSeven,2,698,291,488,252,236,55,45,51,13,38,0
11-08-2021,CelestialInterface,3,471,220,319,227,92,75,18,73,64,9,6
11-08-2021,CelestialInterface,3,318,38,153,60,93,81,79,10,1,9,0
11-08-2021,Honeycomb,1,708,259,191,44,147,51,6,43,1,42,5
11-08-2021,Honeycomb,2,665,119,495,191,304,62,38,2,1,1,0
11-08-2021,PrimeSeven,3,812,165,297,6,291,79,18,61,39,22,0
11-08-2021,Discovery,1,662,34,314,103,211,97,92,23,2,21,1
11-08-2022,GrayPanthers,2,860,152,86,40,46,53,6,14,2,12,0
11-08-2022,PrimeSeven,2,986,232,821,206,615,80,22,20,16,4,2
11-08-2022,ImpactTraining,2,497,278,3,1,2,62,25,32,24,8,3
11-08-2022,Quicksilver,2,212,81,188,160,28,75,38,21,11,10,1
11-08-2022,BitterLaser,1,169,112,83,67,16,56,50,42,23,19,0
11-08-2022,ImpactTraining,1,484,451,317,161,156,57,44,25,8,17,0
11-08-2022,Discovery,1,788,677,508,223,285,90,54,68,31,37,6
11-08-2022,PrimeSeven,3,871,637,452,66,386,100,62,87,85,2,2
11-08-2022,Quicksilver,3,108,42,20,7,13,66,62,17,1,16,0
11-08-2022,Quicksilver,3,973,310,572,214,358,80,78,11,4,7,0
11-08-2023,BitterLaser,1,695,206,377,133,244,83,20,29,21,8,0
11-08-2023,PrimeSeven,3,897,179,310,190,120,61,23,34,22,12,3
11-08-2023,Mustangs,1,643,341,162,35,127,91,60,6,5,1,0
11-08-2023,ImpactTraining,3,183,78,12,6,6,81,31,56,4,52,3
11-08-2023,PrimeSeven,1,171,113,134,72,62,72,63,35,5,30,3
11-08-2023,Discovery,1,347,85,284,169,115,69,45,57,44,13,7
11-08-2023,Honeycomb,2,913,873,807,464,343,73,33,10,1,9,0
11-08-2023,Mustangs,1,984,190,16,2,14,67,54,15,13,2,1
11-08-2023,ImpactTraining,3,885,678,614,107,507,93,46,17,6,11,1
11-08-2023,Quicksilver,3,899,843,878,837,41,52,3,18,4,14,0
11-08-2023,Mustangs,1,218,150,157,151,6,71,70,39,16,23,4
11-08-2023,BitterLaser,2,822,418,402,252,150,67,56,61,29,32,3
11-09-2021,Quicksilver,3,813,619,171,120,51,63,9,4,1,3,0
11-09-2021,GrayPanthers,2,546,202,129,52,77,67,22,33,21,12,1
11-09-2021,ImpactTraining,1,554,392,435,348,87,84,19,50,49,1,2
11-09-2021,CelestialInterface,2,245,196,15,12,3,52,25,28,14,14,2
11-09-2021,GrayPanthers,2,926,590,705,375,330,97,14,82,69,13,6
11-09-2021,PrimeSeven,2,265,94,37,9,28,84,35,74,53,21,6
11-09-2021,CelestialInterface,1,912,377,178,38,140,78,44,44,36,8,5
11-09-2021,GrayPanthers,1,117,47,78,24,54,51,42,1,0,1,0
11-09-2021,Quicksilver,3,792,741,381,349,32,100,80,89,9,80,5
11-09-2021,Mustangs,1,734,126,508,133,375,100,52,85,30,55,7
11-09-2022,Discovery,1,637,596,595,150,445,91,54,13,2,11,0
11-09-2022,Discovery,3,801,589,367,290,77,72,30,60,46,14,1
11-09-2022,Honeycomb,1,356,59,37,29,8,81,34,55,18,37,0
11-09-2022,CelestialInterface,1,195,111,25,21,4,59,15,58,39,19,2
11-09-2022,Discovery,1,329,291,69,48,21,67,50,23,16,7,0
11-09-2022,Discovery,3,263,195,210,64,146,78,45,4,2,2,0
11-09-2022,Quicksilver,1,217,199,150,6,144,70,29,65,51,14,4
11-09-2022,BitterLaser,1,943,439,41,23,18,78,20,55,3,52,5
11-09-2023,Aurora,3,767,261,556,82,474,59,5,14,5,9,1
11-09-2023,Honeycomb,1,108,3,43,6,37,66,29,57,55,2,0
11-09-2023,GrayPanthers,1,356,8,100,36,64,67,7,11,10,1,0
11-09-2023,Mustangs,1,626,123,142,64,78,65,21,64,6,58,6
11-09-2023,Quicksilver,3,882,302,507,240,267,58,16,28,11,17,2
11-09-2023,BitterLaser,3,978,2,651,268,383,63,0,37,13,24,1
11-09-2023,CelestialInterface,2,967,506,566,536,30,76,19,56,22,34,4
11-09-2023,Honeycomb,2,569,198,229,49,180,94,59,41,36,5,3
11-09-2023,GrayPanthers,1,308,223,252,109,143,85,74,78,37,41,10
11-09-2023,Discovery,2,550,134,356,17,339,62,52,14,7,7,0
11-10-2021,PrimeSeven,2,107,56,20,8,12,54,18,2,1,1,0
11-10-2021,ImpactTraining,2,361,67,241,203,38,87,77,10,8,2,0
11-10-2021,Aurora,3,293,181,90,9,81,65,6,46,0,46,1
11-10-2021,Mustangs,3,902,116,731,178,553,62,0,55,23,32,1
11-10-2021,GrayPanthers,3,919,587,333,24,309,100,69,50,10,40,5
11-10-2021,GrayPanthers,2,160,93,132,92,40,61,11,3,2,1,0
11-10-2021,ImpactTraining,2,587,113,416,296,120,88,22,6,1,5,0
11-10-2021,Mustangs,3,569,87,51,24,27,85,71,56,16,40,0
11-10-2022,ImpactTraining,3,963,668,447,2,445,74,11,1,0,1,0
11-10-2022,Discovery,2,477,414,389,212,177,53,49,16,7,9,1
11-10-2022,Mustangs,1,778,348,440,286,154,69,45,31,23,8,1
11-10-2022,Aurora,3,401,375,217,90,127,59,12,36,22,14,0
11-10-2022,Aurora,2,437,350,419,118,301,57,29,22,1,21,2
11-10-2022,Quicksilver,1,252,61,177,68,109,86,59,8,3,5,0
11-10-2022,Discovery,3,404,299,153,123,30,54,33,14,7,7,1
11-10-2022,Discovery,3,948,204,334,108,226,95,61,67,21,46,5
11-10-2022,Aurora,3,641,545,80,45,35,78,69,30,25,5,1
11-10-2022,Discovery,3,624,594,546,340,206,80,54,27,4,23,1
11-10-2023,PrimeSeven,1,978,946,761,63,698,75,50,58,45,13,5
11-10-2023,Mustangs,1,317,274,50,1,49,56,47,26,6,20,2
11-10-2023,BitterLaser,3,307,206,132,40,92,54,10,40,32,8,4
11-10-2023,Aurora,1,273,251,92,58,34,54,24,5,4,1,0
11-10-2023,Honeycomb,2,258,253,117,4,113,82,54,60,21,39,0
11-10-2023,Mustangs,3,459,138,186,114,72,100,74,93,74,19,3
11-10-2023,PrimeSeven,2,203,50,102,69,33,52,11,2,1,1,0
11-10-2023,CelestialInterface,1,133,130,119,45,74,82,12,5,1,4,0
11-11-2021,PrimeSeven,1,434,322,32,12,20,88,42,81,52,29,7
11-11-2021,ImpactTraining,2,873,558,495,200,295,59,41,5,2,3,0
11-11-2021,Discovery,2,622,6,305,101,204,59,41,55,28,27,0
11-11-2021,ImpactTraining,3,781,168,18,16,2,50,6,8,5,3,0
11-11-2021,ImpactTraining,1,600,236,576,14,562,74,38,28,18,10,3
11-11-2021,ImpactTraining,3,847,471,377,87,290,65,16,17,8,9,1
11-11-2022,ImpactTraining,1,923,457,5,2,3,68,25,65,22,43,2
11-11-2022,Discovery,2,542,452,4,2,2,72,62,42,39,3,4
11-11-2022,GrayPanthers,3,277,162,98,66,32,58,57,2,1,1,0
11-11-2022,Quicksilver,2,921,551,189,8,181,64,47,12,11,1,0
11-11-2022,Honeycomb,1,762,544,246,213,33,78,25,16,13,3,0
11-11-2022,ImpactTraining,3,422,41,346,325,21,60,25,15,1,14,0
11-11-2022,Discovery,2,895,816,416,328,88,95,20,60,35,25,5
11-11-2022,GrayPanthers,1,247,105,90,75,15,76,4,63,10,53,8
11-11-2022,ImpactTraining,2,766,579,735,348,387,85,41,2,0,2,0
11-11-2022,Mustangs,1,257,39,219,2,217,63,27,18,1,17,0
11-11-2023,PrimeSeven,2,325,245,27,9,18,50,21,46,14,32,4
11-11-2023,GrayPanthers,2,810,723,170,130,40,84,69,5,1,4,0
11-11-2023,Honeycomb,2,615,360,318,53,265,68,44,10,7,3,0
11-11-2023,Quicksilver,3,753,4,67,45,22,68,21,67,4,63,5
11-11-2023,Aurora,3,141,115,21,20,1,98,80,59,50,9,1
11-11-2023,PrimeSeven,3,648,186,632,166,466,62,38,55,47,8,5
11-11-2023,PrimeSeven,2,265,103,106,24,82,93,52,44,21,23,0
11-11-2023,ImpactTraining,3,687,573,70,41,29,82,23,50,48,2,3
11-11-2023,ImpactTraining,3,660,174,405,43,362,97,88,23,13,10,2
11-11-2023,Aurora,2,783,58,646,499,147,97,94,74,37,37,10
11-11-2023,GrayPanthers,3,758,587,347,170,177,97,7,16,11,5,1
11-11-2023,PrimeSeven,2,943,916,862,287,575,74,35,47,2,45,4
11-11-2023,Aurora,1,614,167,428,227,201,69,20,36,33,3,2
11-12-2021,Quicksilver,2,550,270,78,12,66,61,30,12,10,2,0
11-12-2021,Aurora,2,692,301,526,185,341,55,16,2,1,1,0
11-12-2021,PrimeSeven,2,630,180,473,137,336,61,30,35,21,14,4
11-12-2021,CelestialInterface,1,373,84,167,117,50,58,38,30,16,14,3
11-12-2021,Honeycomb,3,974,416,147,49,98,53,40,49,39,10,4
11-12-2021,Discovery,2,693,617,302,34,268,66,1,65,2,63,4
11-12-2021,Aurora,1,792,689,573,135,438,92,41,32,0,32,3
11-12-2021,CelestialInterface,2,629,578,434,357,77,80,75,29,9,20,0
11-12-2022,Mustangs,3,961,610,638,141,497,53,30,20,3,17,1
11-12-2022,GrayPanthers,2,612,13,201,72,129,88,25,53,19,34,0
11-12-2022,Quicksilver,1,249,238,145,45,100,55,11,20,1,19,1
11-12-2022,GrayPanthers,2,125,89,47,19,28,85,17,21,9,12,0
11-12-2022,Discovery,1,453,381,375,107,268,80,3,12,11,1,0
11-12-2022,GrayPanthers,1,895,860,752,431,321,66,26,64,11,53,1
11-12-2022,Aurora,3,622,252,360,353,7,99,33,59,42,17,3
11-12-2022,CelestialInterface,2,342,150,299,235,64,89,3,8,2,6,0
11-12-2022,CelestialInterface,2,813,463,766,286,480,55,23,49,13,36,1
11-12-2022,GrayPanthers,2,593,71,141,111,30,55,52,17,3,14,1
11-12-2023,Aurora,2,353,194,209,202,7,56,26,1,0,1,0
11-12-2023,Mustangs,3,668,98,493,27,466,71,34,6,0,6,0
11-12-2023,GrayPanthers,3,573,384,350,113,237,70,46,23,14,9,2
11-12-2023,Aurora,3,562,89,544,196,348,87,3,65,31,34,5
11-12-2023,Quicksilver,1,829,183,298,24,274,72,30,19,16,3,1
11-12-2023,Discovery,2,245,172,29,19,10,92,56,64,4,60,4
11-12-2023,Discovery,2,756,93,50,11,39,52,41,38,3,35,4
11-12-2023,Mustangs,3,251,177,125,103,22,73,65,68,41,27,1
11-12-2023,Honeycomb,1,472,257,185,123,62,89,69,51,48,3,4
11-12-2023,Mustangs,2,441,86,130,84,46,86,64,71,47,24,1
12-01-2021,Discovery,2,820,86,524,464,60,94,50,27,2,25,1
12-01-2021,PrimeSeven,1,388,244,81,71,10,75,26,25,11,14,0
12-01-2021,GrayPanthers,3,893,14,573,261,312,83,63,8,4,4,0
12-01-2021,BitterLaser,1,222,34,35,10,25,81,10,76,51,25,3
12-01-2021,Aurora,3,885,298,59,44,15,53,40,6,4,2,0
12-01-2021,Mustangs,1,246,215,13,10,3,65,27,7,2,5,0
12-01-2021,Quicksilver,3,383,145,365,267,98,70,11,67,6,61,4
12-01-2021,Quicksilver,2,909,98,601,286,315,59,10,40,3,37,1
12-01-2021,Discovery,1,141,34,42,33,9,60,22,17,16,1,0
12-01-2021,CelestialInterface,1,333,179,309,120,189,79,19,58,38,20,5
12-01-2022,CelestialInterface,2,587,39,432,53,379,92,51,62,59,3,2
12-01-2022,Discovery,3,294,115,96,53,43,100,49,31,26,5,1
12-01-2022,ImpactTraining,3,168,16,87,16,71,78,47,55,54,1,3
12-01-2022,BitterLaser,3,123,88,63,38,25,86,9,77,1,76,4
12-01-2022,Quicksilver,3,634,285,268,204,64,79,64,78,23,55,8
12-01-2022,Quicksilver,1,192,124,185,137,48,76,56,27,25,2,0
12-01-2022,GrayPanthers,2,138,50,127,6,121,70,1,35,28,7,0
12-01-2022,Discovery,2,580,551,23,22,1,60,25,12,9,3,0
12-01-2022,Honeycomb,2,720,709,8,7,1,85,21,2,0,2,0
12-01-2022,CelestialInterface,3,974,389,339,218,121,50,40,0,0,0,0
12-01-2023,GrayPanthers,2,369,81,53,49,4,86,56,71,10,61,9
12-01-2023,Discovery,2,489,397,160,16,144,99,21,0,0,0,0
12-01-2023,ImpactTraining,2,329,312,131,73,58,72,64,44,16,28,4
12-01-2023,Aurora,2,332,48,154,67,87,97,55,31,0,31,2
12-01-2023,Aurora,2,241,136,150,55,95,72,56,69,43,26,9
12-01-2023,Aurora,1,799,752,437,277,160,60,3,23,4,19,2
12-01-2023,CelestialInterface,1,476,202,370,167,203,67,6,13,1,12,0
12-01-2023,Quicksilver,2,213,117,176,143,33,72,7,68,30,38,9
12-02-2021,BitterLaser,1,219,212,120,67,53,50,3,21,19,2,1
12-02-2021,GrayPanthers,3,332,43,104,79,25,60,8,40,39,1,5
12-02-2021,GrayPanthers,1,564,490,199,149,50,80,76,34,16,18,2
12-02-2021,Honeycomb,1,698,346,182,98,84,65,2,37,28,9,3
12-02-2021,Discovery,2,269,136,107,27,80,90,14,62,6,56,3
12-02-2021,Honeycomb,1,495,38,175,0,175,68,24,50,27,23,5
12-02-2021,Quicksilver,1,641,633,511,294,217,55,0,1,0,1,0
12-02-2021,Quicksilver,1,883,695,733,661,72,86,30,18,10,8,1
12-02-2021,BitterLaser,3,171,138,116,37,79,87,31,66,9,57,2
12-02-2021,Mustangs,3,570,461,73,5,68,59,7,42,17,25,1
12-02-2021,Mustangs,2,853,410,56,19,37,90,58,45,7,38,2
12-02-2021,ImpactTraining,2,376,347,353,118,235,61,41,2,1,1,0
12-02-2021,CelestialInterface,3,547,314,20,1,19,79,51,65,22,43,5
12-02-2021,Mustangs,1,481,189,306,181,125,53,26,34,2,32,2
12-02-2021,Quicksilver,3,782,390,263,84,179,72,39,19,8,11,0
12-02-2021,Quicksilver,2,340,204,202,192,10,95,43,92,46,46,9
12-02-2022,CelestialInterface,1,440,242,182,131,51,81,5,1,0,1,0
12-02-2022,Quicksilver,1,487,417,302,149,153,94,43,43,40,3,5
12-02-2022,Honeycomb,2,800,399,450,75,375,85,67,81,33,48,5
12-02-2022,Mustangs,1,518,385,181,3,178,62,48,46,31,15,3
12-02-2022,PrimeSeven,3,693,185,64,31,33,96,18,37,11,26,0
12-02-2022,Quicksilver,1,200,143,167,15,152,66,8,4,0,4,0
12-02-2022,ImpactTraining,3,885,79,578,563,15,68,10,27,9,18,3
12-02-2022,BitterLaser,2,687,442,4,2,2,75,26,18,16,2,0
12-02-2022,PrimeSeven,3,772,36,587,534,53,92,3,24,18,6,1
12-02-2023,ImpactTraining,3,565,527,240,43,197,93,9,53,11,42,6
12-02-2023,Honeycomb,1,480,99,148,44,104,58,34,39,0,39,1
12-02-2023,Mustangs,3,178,78,82,4,78,59,29,48,40,8,0
12-02-2023,PrimeSeven,2,192,0,39,5,34,67,33,12,1,11,0
12-02-2023,PrimeSeven,3,910,301,569,211,358,82,8,13,9,4,0
12-02-2023,Aurora,3,139,11,43,28,15,88,42,50,39,11,2
12-02-2023,BitterLaser,2,106,5,99,47,52,72,66,10,6,4,0
12-03-2021,CelestialInterface,1,111,63,41,16,25,97,22,44,17,27,0
12-03-2021,Honeycomb,1,177,25,109,89,20,83,1,67,21,46,4
12-03-2021,Honeycomb,3,426,300,143,30,113,94,4,76,55,21,9
12-03-2021,Aurora,2,543,112,323,66,257,66,65,55,18,37,5
12-03-2021,Mustangs,1,889,135,852,489,363,86,45,63,52,11,3
12-03-2021,Honeycomb,1,207,153,44,8,36,85,68,58,14,44,6
12-03-2021,Honeycomb,2,765,49,221,2,219,78,8,56,20,36,4
12-03-2021,PrimeSeven,1,770,536,323,211,112,92,90,49,26,23,6
12-03-2021,CelestialInterface,2,186,0,149,131,18,82,59,29,9,20,0
12-03-2021,Discovery,1,246,125,137,19,118,87,51,69,54,15,3
12-03-2022,ImpactTraining,3,220,149,81,44,37,75,23,44,22,22,3
12-03-2022,Honeycomb,2,752,227,419,269,150,89,29,34,26,8,0
12-03-2022,Mustangs,3,225,127,179,141,38,79,76,35,15,20,4
12-03-2022,GrayPanthers,2,175,150,132,82,50,68,29,60,50,10,3
12-03-2022,GrayPanthers,2,189,75,86,25,61,85,56,68,44,24,5
12-03-2022,Honeycomb,2,220,63,216,105,111,67,53,27,1,26,3
12-03-2022,Honeycomb,3,784,204,152,15,137,84,71,79,20,59,8
12-03-2022,BitterLaser,3,797,770,308,283,25,65,60,53,6,47,1
12-03-2023,ImpactTraining,2,901,677,98,5,93,83,42,45,2,43,2
12-03-2023,CelestialInterface,3,730,677,154,117,37,88,37,6,0,6,0
12-03-2023,Mustangs,3,865,452,252,153,99,95,46,88,37,51,8
12-03-2023,CelestialInterface,2,271,263,4,3,1,94,23,47,17,30,2
12-03-2023,PrimeSeven,2,886,824,667,66,601,69,42,10,8,2,0
12-03-2023,Honeycomb,2,996,220,60,52,8,92,37,44,18,26,2
12-03-2023,Quicksilver,1,783,167,451,279,172,64,62,45,8,37,0
12-03-2023,GrayPanthers,2,706,668,333,315,18,70,68,57,2,55,6
12-03-2023,Aurora,3,616,335,63,44,19,85,74,54,13,41,6
12-03-2023,GrayPanthers,1,246,93,146,98,48,57,0,31,20,11,2
12-03-2023,PrimeSeven,1,316,196,118,18,100,58,37,56,31,25,7
12-04-2021,Aurora,1,216,84,170,75,95,75,63,25,8,17,0
12-04-2021,Honeycomb,3,878,181,59,56,3,57,34,43,4,39,2
12-04-2021,ImpactTraining,2,637,278,440,133,307,65,4,42,8,34,2
12-04-2021,Quicksilver,1,924,315,441,201,240,59,22,20,8,12,0
12-04-2021,ImpactTraining,3,633,419,530,214,316,98,8,0,0,0,0
12-04-2022,CelestialInterface,1,380,358,172,109,63,65,64,64,37,27,7
12-04-2022,Aurora,2,173,38,63,28,35,66,32,38,13,25,4
12-04-2022,ImpactTraining,3,726,306,97,1,96,67,37,26,16,10,0
12-04-2022,Honeycomb,1,526,339,274,158,116,84,20,18,14,4,1
12-04-2022,CelestialInterface,3,488,245,347,187,160,83,25,80,56,24,1
12-04-2022,Honeycomb,2,411,323,172,65,107,54,32,8,1,7,0
12-04-2022,Quicksilver,3,294,99,205,93,112,87,71,51,33,18,2
12-04-2023,ImpactTraining,2,948,236,263,36,227,80,42,67,48,19,3
12-04-2023,PrimeSeven,2,949,886,400,317,83,66,55,27,12,15,3
12-04-2023,Aurora,2,472,82,180,26,154,99,16,54,36,18,3
12-04-2023,Quicksilver,2,762,223,515,303,212,54,23,16,2,14,1
12-04-2023,PrimeSeven,3,672,228,247,8,239,68,40,30,0,30,1
12-04-2023,Quicksilver,1,439,75,194,179,15,50,17,42,12,30,3
12-04-2023,ImpactTraining,2,233,66,100,13,87,95,6,35,12,23,2
12-04-2023,GrayPanthers,2,867,786,773,587,186,66,57,3,2,1,0
12-04-2023,BitterLaser,1,494,423,293,267,26,58,0,28,0,28,1
12-04-2023,Mustangs,1,705,268,544,379,165,99,19,76,2,74,9
12-04-2023,Mustangs,1,653,297,189,126,63,71,40,66,52,14,1
12-05-2021,PrimeSeven,2,669,335,469,266,203,67,13,25,24,1,2
12-05-2021,CelestialInterface,1,557,134,356,352,4,97,80,77,29,48,10
12-05-2021,GrayPanthers,2,227,183,129,86,43,60,50,29,10,19,2
12-05-2021,CelestialInterface,2,391,176,284,8,276,98,84,89,56,33,5
12-05-2021,Honeycomb,3,253,7,120,102,18,72,17,52,4,48,5
12-05-2021,PrimeSeven,3,194,98,77,32,45,92,74,51,3,48,3
12-05-2021,CelestialInterface,2,294,204,151,117,34,96,54,93,51,42,11
12-05-2021,BitterLaser,2,311,137,105,16,89,55,25,30,21,9,0
12-05-2021,ImpactTraining,2,556,548,508,65,443,100,60,4,0,4,0
12-05-2021,Mustangs,1,883,64,769,355,414,60,28,37,18,19,4
12-05-2022,GrayPanthers,2,492,313,359,291,68,58,46,4,2,2,0
12-05-2022,PrimeSeven,3,166,16,23,13,10,62,52,2,1,1,0
12-05-2022,Discovery,1,728,313,429,388,41,78,35,40,9,31,5
12-05-2022,Aurora,1,602,256,14,9,5,65,8,29,18,11,0
12-05-2022,Aurora,1,121,14,72,30,42,63,41,5,0,5,0
12-05-2022,Quicksilver,3,101,3,33,23,10,52,38,10,7,3,0
12-05-2022,Honeycomb,2,152,121,4,1,3,58,30,16,14,2,0
12-05-2022,Discovery,3,346,340,298,22,276,51,20,31,9,22,2
12-05-2022,Aurora,2,655,531,271,71,200,60,37,37,13,24,2
12-05-2022,BitterLaser,3,994,535,624,530,94,88,34,67,35,32,8
12-05-2022,CelestialInterface,1,872,598,313,8,305,67,28,49,0,49,4
12-05-2022,Honeycomb,3,892,732,475,454,21,98,75,16,11,5,1
12-05-2022,Quicksilver,2,469,221,92,74,18,81,54,36,6,30,4
12-05-2022,CelestialInterface,1,418,236,195,62,133,85,30,84,57,27,4
12-05-2022,Honeycomb,3,454,146,174,78,96,74,31,24,15,9,0
12-05-2022,Discovery,1,622,490,92,86,6,64,14,32,11,21,0
12-05-2022,Quicksilver,1,551,550,175,63,112,74,49,22,19,3,0
12-05-2022,ImpactTraining,3,107,62,43,26,17,50,1,36,16,20,3
12-05-2022,Discovery,1,290,226,198,42,156,88,59,87,69,18,11
12-05-2023,Quicksilver,2,140,28,25,16,9,83,70,8,7,1,0
12-05-2023,ImpactTraining,1,553,377,56,20,36,68,10,45,11,34,1
12-05-2023,Aurora,2,549,480,514,180,334,98,14,37,21,16,0
12-05-2023,BitterLaser,3,927,660,322,268,54,89,25,88,77,11,3
12-05-2023,Honeycomb,1,117,25,30,6,24,80,39,66,24,42,6
12-05-2023,Quicksilver,1,336,211,320,244,76,76,39,38,19,19,1
12-05-2023,GrayPanthers,2,584,100,496,382,114,87,13,86,37,49,3
12-06-2021,GrayPanthers,3,399,380,197,187,10,63,47,16,6,10,1
12-06-2021,CelestialInterface,3,594,348,136,46,90,97,81,89,56,33,8
12-06-2021,Aurora,1,531,328,101,95,6,76,10,56,31,25,0
12-06-2021,Discovery,3,443,16,207,104,103,85,35,62,40,22,0
12-06-2021,Honeycomb,1,935,125,759,126,633,94,48,59,50,9,2
12-06-2021,Honeycomb,2,342,245,27,6,21,92,54,47,11,36,4
12-06-2022,Mustangs,1,812,389,299,16,283,94,40,54,27,27,5
12-06-2022,GrayPanthers,2,274,56,224,84,140,99,17,7,2,5,0
12-06-2022,Quicksilver,1,618,148,224,209,15,71,5,52,1,51,0
12-06-2022,BitterLaser,3,845,164,757,81,676,74,11,71,25,46,3
12-06-2022,Honeycomb,1,959,492,895,483,412,98,37,13,6,7,0
12-06-2022,Aurora,2,410,38,68,62,6,88,13,10,5,5,0
12-06-2022,BitterLaser,2,740,462,654,628,26,53,36,12,5,7,0
12-06-2022,GrayPanthers,3,299,256,197,41,156,85,30,55,16,39,5
12-06-2022,PrimeSeven,2,854,567,515,475,40,86,16,9,7,2,0
12-06-2022,Discovery,1,389,294,17,5,12,98,17,6,1,5,0
12-06-2023,CelestialInterface,3,291,281,145,47,98,90,86,35,20,15,0
12-06-2023,Aurora,3,160,114,128,27,101,99,12,65,63,2,4
12-06-2023,PrimeSeven,2,149,18,110,49,61,94,66,69,39,30,2
12-06-2023,Mustangs,3,566,460,21,19,2,86,76,41,3,38,4
12-06-2023,Honeycomb,3,504,111,455,140,315,68,24,27,15,12,1
12-06-2023,Discovery,2,214,36,105,103,2,92,33,73,34,39,8
12-06-2023,Honeycomb,3,170,75,150,82,68,96,22,2,1,1,0
12-07-2021,GrayPanthers,2,513,119,291,221,70,87,13,71,15,56,7
12-07-2021,Discovery,1,947,224,446,135,311,95,62,89,26,63,2
12-07-2021,CelestialInterface,1,701,125,455,412,43,69,64,11,9,2,0
12-07-2021,Mustangs,1,319,277,230,94,136,100,8,98,31,67,9
12-07-2021,Discovery,2,209,170,156,64,92,73,40,14,1,13,0
12-07-2022,BitterLaser,2,994,490,350,140,210,65,16,15,7,8,1
12-07-2022,Mustangs,1,435,130,389,44,345,71,13,0,0,0,0
12-07-2022,BitterLaser,3,769,337,670,64,606,73,37,5,1,4,0
12-07-2022,ImpactTraining,1,644,50,472,74,398,67,11,45,1,44,1
12-07-2022,PrimeSeven,3,804,749,678,71,607,97,43,78,50,28,9
12-07-2022,Quicksilver,1,740,468,693,621,72,95,73,89,39,50,10
12-07-2023,GrayPanthers,3,398,110,271,127,144,55,40,32,15,17,2
12-07-2023,BitterLaser,2,803,490,338,87,251,79,39,76,51,25,7
12-07-2023,CelestialInterface,2,892,698,538,249,289,88,79,47,43,4,4
12-07-2023,Aurora,2,637,635,136,78,58,65,4,40,5,35,2
12-07-2023,PrimeSeven,1,307,289,47,40,7,84,35,45,44,1,5
12-07-2023,Aurora,2,381,359,257,28,229,71,38,58,50,8,7
12-08-2021,Mustangs,3,313,36,93,32,61,72,37,35,11,24,4
12-08-2021,BitterLaser,1,974,872,662,531,131,98,16,36,22,14,4
12-08-2021,Aurora,1,439,200,141,113,28,81,0,20,9,11,1
12-08-2021,Discovery,3,498,430,273,103,170,57,45,52,19,33,5
12-08-2021,Discovery,1,808,539,221,39,182,91,22,20,6,14,0
12-08-2021,ImpactTraining,1,191,145,19,9,10,72,55,44,41,3,2
12-08-2021,GrayPanthers,3,183,172,85,27,58,81,3,17,7,10,0
12-08-2022,ImpactTraining,3,812,716,398,325,73,90,24,34,26,8,2
12-08-2022,Discovery,3,273,100,260,35,225,72,37,5,0,5,0
12-08-2022,GrayPanthers,1,549,345,79,41,38,51,11,31,6,25,0
12-08-2022,Discovery,3,885,23,348,50,298,92,68,51,3,48,2
12-08-2022,GrayPanthers,2,975,408,91,37,54,88,35,5,0,5,0
12-08-2022,Discovery,2,499,223,281,268,13,68,39,6,3,3,0
12-08-2022,Honeycomb,2,507,185,205,69,136,78,10,67,11,56,1
12-08-2022,ImpactTraining,2,148,76,90,42,48,95,42,81,9,72,7
12-08-2022,Quicksilver,1,510,278,137,66,71,80,26,55,53,2,3
12-08-2022,Discovery,1,924,609,5,1,4,51,50,5,2,3,0
12-08-2023,Aurora,1,878,290,14,6,8,85,81,82,12,70,4
12-08-2023,CelestialInterface,3,732,489,130,13,117,56,37,55,13,42,2
12-08-2023,ImpactTraining,1,211,56,2,0,2,94,11,18,10,8,0
12-08-2023,CelestialInterface,2,768,470,261,20,241,92,16,79,4,75,9
12-08-2023,GrayPanthers,1,589,25,252,147,105,51,11,49,40,9,0
12-08-2023,Honeycomb,2,319,86,125,7,118,100,84,36,5,31,4
12-08-2023,Aurora,3,966,813,59,23,36,81,3,15,11,4,0
12-08-2023,Quicksilver,1,178,34,62,45,17,60,4,48,8,40,1
12-08-2023,ImpactTraining,1,553,338,453,139,314,93,28,31,24,7,3
12-08-2023,PrimeSeven,1,261,255,199,153,46,64,57,56,24,32,3
12-08-2023,BitterLaser,3,113,47,21,15,6,59,55,0,0,0,0
12-08-2023,Honeycomb,1,946,656,325,156,169,59,44,27,10,17,2
12-09-2021,Honeycomb,2,908,126,178,68,110,94,67,93,17,76,6
12-09-2021,GrayPanthers,2,744,201,123,83,40,85,39,66,35,31,3
12-09-2021,Quicksilver,1,995,892,943,903,40,56,47,3,1,2,0
12-09-2021,Mustangs,3,799,212,444,239,205,67,51,35,3,32,4
12-09-2021,Quicksilver,3,351,112,153,1,152,83,2,50,18,32,5
12-09-2021,Discovery,2,364,191,181,175,6,81,24,3,1,2,0
12-09-2021,Aurora,3,827,348,372,240,132,99,10,57,32,25,3
12-09-2022,Honeycomb,1,525,332,213,7,206,70,20,33,27,6,1
12-09-2022,Aurora,1,184,134,161,128,33,72,71,46,7,39,4
12-09-2022,Honeycomb,1,859,265,740,691,49,67,37,30,6,24,0
12-09-2022,Discovery,1,640,320,13,11,2,96,4,36,23,13,0
12-09-2023,Mustangs,3,276,115,179,94,85,89,85,63,26,37,0
12-09-2023,ImpactTraining,1,779,737,455,388,67,94,24,37,10,27,4
12-09-2023,BitterLaser,3,779,24,59,24,35,91,36,80,20,60,4
12-09-2023,GrayPanthers,2,586,222,74,73,1,100,48,95,83,12,11
12-09-2023,PrimeSeven,2,664,277,631,328,303,61,28,60,5,55,6
12-09-2023,Aurora,3,552,539,54,35,19,70,67,25,4,21,1
12-09-2023,Mustangs,2,769,145,23,0,23,76,42,15,3,12,0
12-10-2021,Quicksilver,1,918,590,348,239,109,78,40,38,34,4,2
12-10-2021,ImpactTraining,2,194,47,106,49,57,53,34,41,6,35,5
12-10-2021,CelestialInterface,1,963,239,797,787,10,52,30,40,15,25,3
12-10-2021,PrimeSeven,1,387,357,328,89,239,100,89,51,28,23,3
12-10-2021,BitterLaser,2,848,666,391,269,122,66,8,7,6,1,0
12-10-2022,Honeycomb,2,193,131,123,48,75,90,14,9,5,4,0
12-10-2022,CelestialInterface,1,362,9,330,96,234,100,6,37,10,27,1
12-10-2022,CelestialInterface,1,223,166,61,28,33,54,35,5,0,5,0
12-10-2022,Mustangs,1,187,172,16,15,1,77,28,61,17,44,8
12-10-2022,Honeycomb,3,767,725,647,534,113,77,21,19,14,5,1
12-10-2023,ImpactTraining,2,430,136,13,9,4,86,27,61,36,25,3
12-10-2023,CelestialInterface,3,658,26,451,87,364,83,32,58,50,8,5
12-10-2023,Mustangs,2,418,211,399,121,278,80,4,3,1,2,0
12-10-2023,GrayPanthers,1,252,81,49,40,9,96,68,92,27,65,0
12-10-2023,Quicksilver,1,506,6,403,32,371,100,63,40,9,31,1
12-10-2023,CelestialInterface,3,189,113,178,131,47,60,57,52,9,43,1
12-10-2023,Honeycomb,1,268,9,32,9,23,69,32,15,2,13,1
12-10-2023,ImpactTraining,1,106,42,11,5,6,71,56,19,7,12,1
12-10-2023,ImpactTraining,3,338,145,244,157,87,94,38,71,21,50,3
12-10-2023,CelestialInterface,2,332,14,22,10,12,93,66,17,2,15,1
12-10-2023,Discovery,2,703,555,484,232,252,82,28,13,2,11,0
12-11-2021,PrimeSeven,3,201,70,80,67,13,96,64,94,89,5,3
12-11-2021,BitterLaser,2,387,243,287,221,66,95,3,5,1,4,0
12-11-2021,ImpactTraining,2,111,86,97,53,44,93,11,91,27,64,10
12-11-2021,PrimeSeven,1,268,261,151,6,145,70,13,12,9,3,0
12-11-2022,Mustangs,1,770,431,420,34,386,77,53,63,52,11,8
12-11-2022,Quicksilver,3,821,283,286,42,244,67,56,45,30,15,1
12-11-2022,BitterLaser,2,207,168,41,24,17,57,17,33,7,26,3
12-11-2022,PrimeSeven,1,711,59,674,664,10,64,58,1,0,1,0
12-11-2022,ImpactTraining,2,595,386,347,189,158,71,12,60,2,58,5
12-11-2022,CelestialInterface,2,322,65,158,155,3,97,81,53,34,19,4
12-11-2022,CelestialInterface,3,327,86,9,1,8,93,18,17,16,1,1
12-11-2022,BitterLaser,3,260,142,37,11,26,56,39,21,15,6,2
12-11-2022,GrayPanthers,3,726,621,345,131,214,57,25,5,2,3,0
12-11-2022,Discovery,1,319,60,188,144,44,55,10,45,10,35,3
12-11-2023,Honeycomb,1,292,283,278,160,118,57,30,56,8,48,4
12-11-2023,BitterLaser,2,964,502,735,375,360,67,49,50,21,29,4
12-11-2023,Quicksilver,3,998,308,699,456,243,77,43,0,0,0,0
12-11-2023,ImpactTraining,3,762,347,296,234,62,100,74,94,3,91,12
12-11-2023,ImpactTraining,3,135,18,114,6,108,84,47,53,31,22,1
12-11-2023,Honeycomb,1,578,356,204,68,136,62,10,33,23,10,0
12-11-2023,Discovery,1,637,276,137,41,96,64,44,24,23,1,1
12-12-2021,GrayPanthers,3,826,13,520,310,210,56,9,1,0,1,0
12-12-2021,CelestialInterface,1,419,411,309,222,87,75,27,58,56,2,1
12-12-2021,GrayPanthers,2,876,595,756,510,246,76,6,68,31,37,0
12-12-2021,PrimeSeven,3,485,381,399,206,193,59,10,46,0,46,0
12-12-2021,Aurora,2,112,24,9,0,9,60,11,43,22,21,0
12-12-2021,Quicksilver,2,885,505,673,201,472,55,43,25,4,21,0
12-12-2022,GrayPanthers,3,858,369,93,68,25,58,19,55,41,14,0
12-12-2022,ImpactTraining,1,311,170,65,48,17,91,2,41,0,41,5
12-12-2022,Honeycomb,3,175,54,12,7,5,94,14,35,11,24,1
12-12-2022,Aurora,3,603,566,404,250,154,76,34,45,27,18,2
12-12-2022,GrayPanthers,1,973,468,777,201,576,53,30,23,20,3,2
12-12-2022,GrayPanthers,3,578,473,203,141,62,88,81,39,12,27,4
12-12-2022,Discovery,2,298,198,224,178,46,57,50,9,1,8,0
12-12-2022,Quicksilver,2,915,827,311,238,73,76,52,29,28,1,0
12-12-2022,ImpactTraining,2,504,299,494,193,301,78,11,62,1,61,4
12-12-2022,ImpactTraining,3,887,79,165,63,102,95,29,5,0,5,0
12-12-2023,BitterLaser,1,592,167,143,69,74,75,5,71,11,60,2
12-12-2023,PrimeSeven,3,983,937,115,1,114,80,52,61,45,16,6
12-12-2023,BitterLaser,3,638,607,377,288,89,56,23,37,4,33,3
12-12-2023,Honeycomb,3,274,114,93,76,17,51,26,19,16,3,1
12-12-2023,GrayPanthers,3,532,45,400,52,348,77,26,0,0,0,0
12-12-2023,Quicksilver,3,566,261,440,49,391,98,81,83,73,10,5
12-12-2023,BitterLaser,3,257,121,75,55,20,59,31,34,16,18,0
12-12-2023,GrayPanthers,3,676,432,221,84,137,86,9,5,4,1,0
12-12-2023,ImpactTraining,3,557,535,416,269,147,100,8,67,13,54,3
13-01-2021,Honeycomb,1,823,526,241,64,177,52,11,32,27,5,2
13-01-2021,CelestialInterface,3,939,635,673,136,537,78,41,19,1,18,0
13-01-2021,Mustangs,2,420,34,231,229,2,73,41,67,16,51,7
13-01-2021,PrimeSeven,3,358,96,274,157,117,77,11,30,25,5,1
13-01-2021,Mustangs,3,614,436,247,199,48,94,36,52,6,46,5
13-01-2021,Mustangs,2,350,71,81,8,73,60,32,11,9,2,0
13-01-2021,Discovery,1,917,451,438,126,312,94,47,34,23,11,3
13-01-2021,Mustangs,2,653,326,610,5,605,94,8,41,10,31,2
13-01-2021,Quicksilver,2,961,145,696,518,178,94,25,66,25,41,4
13-01-2021,PrimeSeven,1,441,318,2,0,2,57,16,23,12,11,0
13-01-2021,GrayPanthers,1,772,109,148,1,147,67,28,4,1,3,0
13-01-2021,ImpactTraining,1,104,2,91,66,25,98,63,33,27,6,3
13-01-2021,BitterLaser,3,922,445,205,96,109,81,3,53,49,4,4
13-01-2022,Discovery,3,579,59,20,15,5,84,49,18,13,5,1
13-01-2022,Mustangs,1,300,253,281,11,270,84,54,77,14,63,2
13-01-2022,CelestialInterface,2,100,40,2,0,2,83,30,36,17,19,0
13-01-2022,GrayPanthers,2,562,259,188,76,112,53,50,36,14,22,4
13-01-2022,Quicksilver,3,706,37,662,151,511,77,0,19,14,5,0
13-01-2022,BitterLaser,2,129,105,5,0,5,56,3,9,4,5,0
13-01-2022,Honeycomb,2,603,482,475,179,296,86,18,35,9,26,2
13-01-2022,GrayPanthers,3,358,164,332,137,195,98,57,61,25,36,6
13-01-2022,Quicksilver,1,942,237,262,147,115,94,5,34,16,18,3
13-01-2022,BitterLaser,3,649,356,31,10,21,52,21,50,48,2,6
13-01-2022,Aurora,3,823,749,719,418,301,52,26,48,27,21,3
13-01-2023,Mustangs,1,356,114,188,59,129,58,26,28,11,17,2
13-01-2023,BitterLaser,3,426,138,312,48,264,99,46,91,41,50,0
13-01-2023,CelestialInterface,3,660,136,479,458,21,57,30,2,0,2,0
13-01-2023,ImpactTraining,3,959,485,893,802,91,98,37,53,17,36,3
13-01-2023,Quicksilver,1,497,178,179,8,171,74,10,25,4,21,1
13-01-2023,Mustangs,2,294,209,290,63,227,85,65,51,48,3,5
13-01-2023,PrimeSeven,3,608,324,602,556,46,87,6,50,38,12,5
13-01-2023,Honeycomb,3,827,366,186,33,153,58,33,27,26,1,0
13-02-2021,Discovery,3,924,341,897,568,329,90,41,25,16,9,1
13-02-2021,Mustangs,3,587,79,462,28,434,86,8,69,0,69,5
13-02-2021,BitterLaser,2,631,364,244,87,157,50,3,3,1,2,0
13-02-2021,ImpactTraining,3,707,149,107,26,81,78,35,12,7,5,0
13-02-2022,BitterLaser,1,373,108,105,101,4,99,92,86,24,62,1
13-02-2022,BitterLaser,3,190,141,71,53,18,73,49,65,4,61,6
13-02-2022,ImpactTraining,1,398,339,187,45,142,88,46,30,26,4,3
13-02-2022,Mustangs,1,176,34,25,22,3,61,49,60,51,9,6
13-02-2022,Quicksilver,3,637,504,541,76,465,81,41,27,3,24,3
13-02-2022,Honeycomb,3,358,351,256,198,58,68,43,28,23,5,1
13-02-2022,BitterLaser,1,150,6,41,32,9,60,28,21,4,17,0
13-02-2023,ImpactTraining,3,456,238,185,147,38,80,5,47,32,15,3
13-02-2023,Aurora,3,591,28,468,414,54,87,14,9,4,5,0
13-02-2023,PrimeSeven,2,836,346,755,208,547,81,15,29,28,1,1
13-02-2023,Aurora,3,896,306,759,530,229,70,61,9,5,4,0
13-02-2023,Aurora,2,980,798,96,2,94,100,86,7,1,6,0
13-02-2023,Discovery,2,660,542,280,31,249,98,53,88,4,84,8
13-02-2023,CelestialInterface,3,122,72,53,36,17,80,64,14,7,7,0
13-02-2023,ImpactTraining,3,833,33,810,198,612,82,3,4,1,3,0
13-02-2023,PrimeSeven,1,996,895,146,143,3,99,11,64,30,34,1
13-02-2023,GrayPanthers,2,373,334,162,55,107,51,5,6,3,3,0
13-02-2023,Discovery,3,888,324,81,76,5,58,42,57,26,31,6
13-02-2023,Honeycomb,1,713,598,250,123,127,99,13,76,51,25,1
13-02-2023,CelestialInterface,3,609,474,293,220,73,70,6,44,39,5,5
13-02-2023,GrayPanthers,1,838,85,374,44,330,93,4,62,19,43,0
13-02-2023,BitterLaser,1,794,327,785,42,743,90,76,38,15,23,0
13-03-2021,Aurora,1,464,414,120,24,96,77,58,20,13,7,2
13-03-2021,BitterLaser,2,238,28,96,91,5,88,45,42,31,11,4
13-03-2021,Mustangs,3,113,53,51,11,40,68,16,19,5,14,0
13-03-2021,Quicksilver,2,573,339,93,71,22,50,43,26,13,13,2
13-03-2021,ImpactTraining,3,912,538,160,49,111,60,59,5,4,1,0
13-03-2021,BitterLaser,3,735,216,537,393,144,52,48,49,18,31,4
13-03-2021,GrayPanthers,1,871,540,758,527,231,100,16,19,11,8,0
13-03-2022,BitterLaser,3,187,166,4,0,4,92,48,43,19,24,5
13-03-2022,PrimeSeven,2,644,202,235,108,127,62,51,25,16,9,0
13-03-2022,Quicksilver,2,108,79,70,30,40,81,27,68,9,59,1
13-03-2022,Aurora,1,838,733,621,584,37,55,32,29,13,16,1
13-03-2022,Honeycomb,2,874,199,84,40,44,88,61,34,9,25,4
13-03-2022,GrayPanthers,2,602,7,10,2,8,53,37,4,2,2,0
13-03-2022,Honeycomb,1,693,577,554,39,515,66,18,43,31,12,2
13-03-2022,BitterLaser,1,663,440,562,322,240,65,39,0,0,0,0
13-03-2022,CelestialInterface,1,900,430,153,56,97,69,20,67,51,16,2
13-03-2022,Quicksilver,1,700,535,280,261,19,100,89,98,89,9,11
13-03-2023,Quicksilver,3,197,146,23,22,1,82,26,55,13,42,3
13-03-2023,Discovery,1,963,754,785,331,454,92,87,33,27,6,3
13-03-2023,GrayPanthers,1,704,236,374,86,288,83,22,54,2,52,2
13-03-2023,BitterLaser,3,342,289,251,70,181,90,7,37,0,37,4
13-03-2023,GrayPanthers,1,254,242,66,51,15,57,10,27,3,24,0
13-03-2023,GrayPanthers,1,383,254,284,166,118,100,50,91,15,76,0
13-03-2023,GrayPanthers,2,303,117,90,9,81,61,53,50,23,27,1
13-03-2023,GrayPanthers,2,552,467,501,212,289,92,4,15,1,14,1
13-03-2023,Aurora,3,973,319,681,471,210,63,49,46,34,12,3
13-04-2021,GrayPanthers,1,997,880,181,98,83,58,11,21,2,19,2
13-04-2021,CelestialInterface,2,479,136,65,49,16,82,22,2,1,1,0
13-04-2021,BitterLaser,3,713,245,628,464,164,55,31,19,12,7,0
13-04-2021,GrayPanthers,1,128,110,110,43,67,53,20,33,1,32,0
13-04-2021,CelestialInterface,3,280,90,85,75,10,94,52,36,11,25,3
13-04-2021,BitterLaser,1,620,378,311,185,126,69,19,61,23,38,8
13-04-2021,Honeycomb,3,829,617,791,242,549,90,78,20,2,18,1
13-04-2021,ImpactTraining,2,731,66,141,52,89,92,40,2,0,2,0
13-04-2021,CelestialInterface,1,240,58,94,83,11,55,24,48,28,20,6
13-04-2021,Quicksilver,3,334,142,209,59,150,94,58,18,5,13,0
13-04-2021,Discovery,1,324,191,92,45,47,82,34,74,6,68,1
13-04-2021,ImpactTraining,1,954,479,94,52,42,97,68,36,16,20,2
13-04-2022,Mustangs,1,969,237,481,209,272,70,47,32,28,4,2
13-04-2022,GrayPanthers,2,753,536,415,167,248,52,14,40,0,40,5
13-04-2022,Discovery,3,168,120,96,24,72,95,82,25,16,9,2
13-04-2022,Quicksilver,1,515,173,489,189,300,86,78,30,5,25,0
13-04-2022,CelestialInterface,1,266,90,135,115,20,84,79,23,13,10,0
13-04-2022,Honeycomb,3,580,374,138,56,82,87,72,7,0,7,0
13-04-2022,PrimeSeven,3,552,83,33,5,28,82,38,60,4,56,3
13-04-2022,Mustangs,2,118,42,94,29,65,54,25,9,6,3,0
13-04-2022,Mustangs,1,922,533,541,403,138,69,6,19,2,17,0
13-04-2022,Mustangs,1,810,286,589,228,361,62,55,40,37,3,1
13-04-2022,Aurora,1,200,190,100,83,17,87,52,80,42,38,2
13-04-2022,Honeycomb,1,691,526,618,289,329,82,79,76,36,40,7
13-04-2022,Discovery,1,642,525,395,234,161,52,26,37,0,37,3
13-04-2023,ImpactTraining,3,907,454,475,309,166,100,53,83,81,2,6
13-04-2023,BitterLaser,1,913,536,68,22,46,88,16,36,22,14,4
13-04-2023,Quicksilver,1,921,624,375,75,300,79,41,10,5,5,0
13-04-2023,Quicksilver,1,695,27,501,303,198,79,72,3,0,3,0
13-05-2021,Aurora,1,929,788,680,66,614,98,3,32,26,6,0
13-05-2021,Aurora,2,398,55,67,46,21,84,78,45,30,15,2
13-05-2021,Discovery,2,497,449,399,328,71,77,26,76,74,2,2
13-05-2021,CelestialInterface,2,135,92,120,95,25,69,23,16,1,15,0
13-05-2021,CelestialInterface,1,602,55,61,13,48,85,26,60,44,16,8
13-05-2022,GrayPanthers,1,491,285,321,36,285,70,30,40,7,33,5
13-05-2022,Quicksilver,2,266,240,200,152,48,97,9,95,80,15,4
13-05-2022,Discovery,2,947,417,172,133,39,97,94,62,50,12,6
13-05-2022,GrayPanthers,2,410,97,279,99,180,94,36,68,10,58,2
13-05-2022,Aurora,3,317,158,220,62,158,78,53,23,5,18,1
13-05-2022,Honeycomb,2,892,79,407,236,171,52,40,27,15,12,3
13-05-2022,ImpactTraining,1,233,164,42,30,12,59,55,42,12,30,0
13-05-2022,BitterLaser,2,511,412,363,37,326,68,38,26,0,26,2
13-05-2022,GrayPanthers,1,601,398,215,156,59,64,41,41,11,30,3
13-05-2022,Mustangs,3,152,55,97,18,79,95,25,2,0,2,0
13-05-2023,Mustangs,2,553,159,380,353,27,72,9,31,14,17,1
13-05-2023,Mustangs,3,190,122,8,0,8,50,13,36,19,17,4
13-05-2023,ImpactTraining,3,478,418,448,320,128,59,8,21,11,10,1
13-05-2023,PrimeSeven,2,154,7,131,71,60,94,75,77,25,52,9
13-05-2023,PrimeSeven,3,296,282,55,45,10,95,22,80,79,1,7
13-05-2023,PrimeSeven,1,198,143,165,131,34,57,10,28,21,7,3
13-05-2023,Mustangs,1,575,224,525,309,216,70,8,38,19,19,0
13-05-2023,BitterLaser,1,845,388,55,41,14,52,5,18,16,2,1
13-05-2023,Quicksilver,3,269,60,139,127,12,65,8,12,3,9,0
13-06-2021,GrayPanthers,3,990,754,244,143,101,99,95,69,58,11,3
13-06-2021,PrimeSeven,2,268,126,3,2,1,52,3,26,23,3,2
13-06-2021,Quicksilver,3,770,115,437,212,225,51,15,39,11,28,1
13-06-2021,BitterLaser,2,959,264,673,136,537,94,45,3,0,3,0
13-06-2021,Mustangs,1,307,40,110,73,37,86,47,44,28,16,0
13-06-2021,GrayPanthers,2,384,262,90,7,83,77,29,44,2,42,2
13-06-2021,Discovery,1,598,67,440,280,160,75,60,49,36,13,2
13-06-2021,CelestialInterface,1,635,239,136,44,92,88,18,23,10,13,2
13-06-2021,CelestialInterface,1,830,745,262,98,164,62,43,30,21,9,2
13-06-2021,CelestialInterface,1,964,427,59,51,8,90,78,66,33,33,0
13-06-2021,PrimeSeven,2,335,185,258,256,2,77,56,73,5,68,1
13-06-2021,ImpactTraining,1,990,252,752,384,368,98,24,24,20,4,2
13-06-2021,ImpactTraining,3,189,84,136,54,82,86,8,8,4,4,0
13-06-2022,Discovery,3,689,494,338,78,260,61,60,47,8,39,6
13-06-2022,ImpactTraining,1,679,414,579,184,395,72,47,18,6,12,1
13-06-2022,Quicksilver,3,933,616,18,13,5,64,36,63,12,51,0
13-06-2022,Quicksilver,2,102,71,89,16,73,99,2,16,11,5,1
13-06-2022,PrimeSeven,3,889,33,513,358,155,69,55,43,32,11,3
13-06-2022,Discovery,1,657,609,336,260,76,59,3,20,18,2,0
13-06-2022,PrimeSeven,1,788,257,637,490,147,82,3,0,0,0,0
13-06-2022,PrimeSeven,3,375,109,120,75,45,54,32,16,6,10,0
13-06-2022,Honeycomb,2,779,389,512,168,344,60,37,21,1,20,0
13-06-2022,Quicksilver,3,911,787,270,20,250,87,77,77,68,9,8
13-06-2023,CelestialInterface,1,883,302,854,791,63,88,3,21,0,21,1
13-06-2023,Mustangs,2,781,464,489,221,268,85,59,32,25,7,0
13-06-2023,Quicksilver,3,444,305,276,127,149,95,43,72,29,43,9
13-06-2023,Honeycomb,2,771,515,223,126,97,95,59,15,4,11,1
13-06-2023,Honeycomb,2,537,153,145,12,133,73,65,71,56,15,1
13-06-2023,Quicksilver,1,107,100,22,0,22,50,29,15,12,3,0
13-06-2023,BitterLaser,1,323,320,62,2,60,97,8,33,20,13,2
13-06-2023,Honeycomb,1,693,158,472,115,357,75,29,35,29,6,1
13-06-2023,PrimeSeven,3,681,332,222,135,87,72,18,37,6,31,1
13-06-2023,CelestialInterface,2,311,252,45,4,41,65,45,54,26,28,2
13-07-2021,BitterLaser,2,330,124,90,22,68,82,55,71,30,41,1
13-07-2021,Aurora,1,981,409,126,116,10,64,44,10,8,2,0
13-07-2021,Aurora,1,582,517,205,125,80,82,44,61,21,40,8
13-07-2021,Mustangs,2,967,139,250,242,8,98,11,11,8,3,0
13-07-2021,Discovery,3,616,429,304,278,26,66,13,0,0,0,0
13-07-2021,ImpactTraining,3,116,32,98,93,5,66,36,20,10,10,1
13-07-2021,Mustangs,2,658,82,529,463,66,59,7,0,0,0,0
13-07-2021,Discovery,3,837,620,779,247,532,50,1,29,23,6,1
13-07-2021,ImpactTraining,3,855,362,395,104,291,66,33,14,5,9,0
13-07-2021,CelestialInterface,3,196,90,141,109,32,53,23,52,35,17,4
13-07-2022,Mustangs,2,488,470,204,87,117,99,25,86,81,5,3
13-07-2022,Quicksilver,2,899,109,436,158,278,83,20,11,6,5,0
13-07-2022,BitterLaser,2,924,673,470,95,375,61,27,11,10,1,0
13-07-2022,BitterLaser,3,587,275,172,55,117,52,21,25,0,25,2
13-07-2022,Aurora,2,625,517,594,268,326,65,35,63,49,14,4
13-07-2022,CelestialInterface,3,484,58,384,284,100,88,35,56,14,42,6
13-07-2022,Honeycomb,1,290,158,210,187,23,63,31,14,2,12,0
13-07-2022,GrayPanthers,3,836,16,710,166,544,74,66,64,49,15,0
13-07-2022,Aurora,3,179,25,173,125,48,78,69,30,29,1,1
13-07-2022,Discovery,1,219,178,5,3,2,63,38,0,0,0,0
13-07-2023,PrimeSeven,3,792,766,385,50,335,71,36,54,28,26,6
13-07-2023,Quicksilver,1,594,497,458,144,314,96,35,3,0,3,0
13-07-2023,Discovery,2,160,130,72,20,52,58,5,24,13,11,1
13-07-2023,PrimeSeven,2,164,8,110,55,55,98,94,60,55,5,5
13-07-2023,BitterLaser,3,255,37,87,39,48,72,51,55,48,7,0
13-07-2023,Aurora,2,403,134,29,0,29,73,5,61,5,56,6
13-08-2021,Quicksilver,3,243,34,128,18,110,81,36,44,43,1,3
13-08-2021,Honeycomb,2,881,440,507,243,264,57,12,36,10,26,0
13-08-2021,PrimeSeven,1,781,58,544,270,274,79,39,15,11,4,1
13-08-2021,PrimeSeven,2,921,651,28,5,23,87,84,37,26,11,3
13-08-2021,ImpactTraining,3,236,137,222,159,63,63,2,61,18,43,4
13-08-2021,CelestialInterface,1,812,634,196,132,64,92,42,77,14,63,6
13-08-2021,CelestialInterface,3,483,143,87,29,58,54,26,2,1,1,0
13-08-2021,Honeycomb,2,182,67,47,40,7,97,58,16,1,15,1
13-08-2021,Honeycomb,3,316,76,236,19,217,74,71,67,47,20,1
13-08-2021,Quicksilver,1,608,170,156,133,23,86,6,34,32,2,1
13-08-2021,Mustangs,1,460,301,426,212,214,96,47,36,28,8,4
13-08-2022,CelestialInterface,2,766,352,16,9,7,79,57,51,19,32,1
13-08-2022,CelestialInterface,2,480,295,367,345,22,54,9,23,14,9,2
13-08-2022,Mustangs,3,598,36,192,64,128,69,64,42,4,38,0
13-08-2022,Discovery,3,329,321,254,86,168,86,80,84,61,23,4
13-08-2022,ImpactTraining,3,927,573,831,601,230,60,47,9,8,1,0
13-08-2022,ImpactTraining,2,724,150,615,250,365,55,39,53,22,31,5
13-08-2022,Quicksilver,3,483,381,405,213,192,87,37,50,16,34,6
13-08-2022,Quicksilver,1,696,240,350,208,142,50,6,3,2,1,0
13-08-2022,BitterLaser,3,399,117,338,145,193,76,6,2,0,2,0
13-08-2022,Mustangs,2,603,55,306,153,153,77,44,74,54,20,2
13-08-2023,PrimeSeven,3,705,458,54,43,11,92,38,25,10,15,2
13-08-2023,Discovery,3,830,445,59,2,57,80,77,49,7,42,3
13-08-2023,PrimeSeven,2,108,29,69,68,1,95,2,34,22,12,1
13-08-2023,Mustangs,3,769,82,491,195,296,52,2,49,1,48,6
13-08-2023,BitterLaser,2,658,624,205,99,106,65,41,57,46,11,0
13-08-2023,Mustangs,2,140,90,19,15,4,92,10,87,53,34,2
13-09-2021,Mustangs,1,419,413,1,0,1,98,28,87,22,65,10
13-09-2021,Aurora,3,946,566,623,546,77,100,76,60,59,1,0
13-09-2021,Mustangs,2,545,258,232,15,217,68,54,27,26,1,3
13-09-2021,Honeycomb,2,193,109,175,15,160,59,29,37,7,30,1
13-09-2021,ImpactTraining,3,757,754,306,62,244,100,39,19,14,5,0
13-09-2021,Aurora,1,949,185,54,15,39,72,33,56,30,26,6
13-09-2021,BitterLaser,1,659,430,569,519,50,65,58,55,29,26,1
13-09-2021,Aurora,3,597,490,374,89,285,85,17,83,54,29,4
13-09-2021,GrayPanthers,1,276,161,115,78,37,53,10,44,14,30,2
13-09-2021,Honeycomb,3,454,29,138,76,62,85,31,84,10,74,11
13-09-2022,Honeycomb,2,335,184,69,21,48,67,62,10,9,1,0
13-09-2022,Quicksilver,2,995,796,443,419,24,83,74,63,23,40,8
13-09-2022,Quicksilver,2,843,601,379,244,135,62,25,47,13,34,1
13-09-2022,Honeycomb,2,244,90,18,5,13,51,17,41,39,2,5
13-09-2023,Mustangs,3,550,175,414,318,96,83,44,76,34,42,10
13-09-2023,Quicksilver,2,220,23,65,27,38,78,74,57,29,28,4
13-09-2023,GrayPanthers,1,696,134,172,5,167,55,9,27,5,22,3
13-09-2023,CelestialInterface,1,713,526,96,51,45,79,68,41,18,23,4
13-09-2023,Quicksilver,1,928,15,687,378,309,69,36,18,7,11,1
13-09-2023,Mustangs,2,325,268,311,141,170,56,27,21,7,14,2
13-09-2023,CelestialInterface,3,304,105,154,140,14,85,46,38,33,5,2
13-09-2023,Discovery,2,898,879,522,286,236,100,20,16,15,1,0
13-09-2023,CelestialInterface,3,498,388,294,225,69,53,46,17,4,13,0
13-09-2023,ImpactTraining,2,159,2,62,40,22,66,27,39,11,28,4
13-10-2021,Discovery,3,812,77,482,446,36,55,49,30,28,2,2
13-10-2021,Aurora,3,239,0,196,5,191,54,4,44,29,15,1
13-10-2021,ImpactTraining,2,594,47,151,137,14,59,2,6,5,1,0
13-10-2021,GrayPanthers,2,742,688,722,166,556,97,80,40,13,27,2
13-10-2021,Aurora,3,866,190,229,23,206,58,16,39,10,29,3
13-10-2021,GrayPanthers,2,565,251,262,72,190,71,46,3,0,3,0
13-10-2021,Quicksilver,2,386,245,118,93,25,60,29,1,0,1,0
13-10-2021,Aurora,2,193,19,88,30,58,66,12,6,2,4,0
13-10-2021,GrayPanthers,3,652,550,267,227,40,91,25,11,4,7,0
13-10-2021,Aurora,2,415,205,120,116,4,63,3,15,5,10,0
13-10-2021,Honeycomb,1,996,612,84,39,45,67,55,62,13,49,3
13-10-2021,BitterLaser,1,156,93,143,94,49,62,25,5,3,2,0
13-10-2021,GrayPanthers,1,179,123,154,23,131,72,38,12,8,4,0
13-10-2021,Aurora,2,277,81,13,10,3,92,28,60,21,39,2
13-10-2022,Aurora,3,412,348,16,12,4,77,8,70,8,62,7
13-10-2022,CelestialInterface,2,373,3,39,1,38,82,67,6,0,6,0
13-10-2022,Honeycomb,2,284,254,191,148,43,56,17,44,24,20,0
13-10-2022,ImpactTraining,2,112,2,48,5,43,96,0,64,59,5,6
13-10-2022,PrimeSeven,3,123,50,20,10,10,86,65,74,68,6,8
13-10-2022,Honeycomb,3,696,308,467,120,347,53,20,38,0,38,0
13-10-2022,Quicksilver,1,903,839,286,228,58,79,5,54,2,52,7
13-10-2022,Quicksilver,1,581,78,503,473,30,65,55,31,14,17,0
13-10-2022,BitterLaser,1,766,375,694,425,269,66,39,3,1,2,0
13-10-2022,CelestialInterface,2,131,49,45,6,39,73,9,47,20,27,4
13-10-2022,ImpactTraining,2,777,597,86,17,69,58,6,12,3,9,0
13-10-2022,Aurora,1,593,391,198,23,175,89,50,3,0,3,0
13-10-2023,GrayPanthers,1,753,523,361,100,261,90,67,41,6,35,1
13-10-2023,Honeycomb,1,845,811,353,338,15,68,52,20,11,9,0
13-10-2023,GrayPanthers,3,933,441,625,449,176,59,19,4,0,4,0
13-10-2023,GrayPanthers,1,444,94,274,83,191,57,53,43,11,32,2
13-10-2023,GrayPanthers,2,462,272,351,349,2,68,20,6,1,5,0
13-10-2023,BitterLaser,1,571,10,350,114,236,82,56,71,3,68,1
13-10-2023,GrayPanthers,2,975,525,250,40,210,60,7,50,0,50,4
13-10-2023,ImpactTraining,3,296,42,74,33,41,86,75,25,4,21,1
13-10-2023,ImpactTraining,1,704,678,371,10,361,72,18,8,6,2,0
13-10-2023,Quicksilver,2,286,175,66,27,39,98,41,70,64,6,8
13-10-2023,PrimeSeven,2,733,180,701,9,692,84,67,53,10,43,1
13-10-2023,Quicksilver,3,557,185,251,66,185,96,88,91,70,21,8
13-10-2023,ImpactTraining,2,532,166,465,178,287,61,36,21,6,15,0
13-10-2023,BitterLaser,1,618,396,434,85,349,70,28,2,1,1,0
13-11-2021,BitterLaser,3,567,148,436,174,262,70,54,15,5,10,0
13-11-2021,Mustangs,2,359,330,173,142,31,77,42,61,7,54,1
13-11-2021,ImpactTraining,1,802,686,20,4,16,86,39,27,14,13,0
13-11-2021,Discovery,1,509,268,257,254,3,99,23,97,41,56,10
13-11-2021,Aurora,1,547,486,61,3,58,86,47,25,8,17,2
13-11-2021,Aurora,3,626,216,375,330,45,74,50,18,12,6,1
13-11-2021,ImpactTraining,3,558,537,357,27,330,53,21,51,45,6,6
13-11-2022,PrimeSeven,2,827,341,288,172,116,73,52,62,44,18,0
13-11-2022,BitterLaser,2,952,538,440,287,153,54,44,4,3,1,0
13-11-2022,ImpactTraining,1,794,595,315,287,28,88,32,78,60,18,9
13-11-2022,PrimeSeven,2,867,470,673,521,152,51,32,20,3,17,2
13-11-2022,BitterLaser,2,282,207,20,17,3,89,9,75,51,24,2
13-11-2022,ImpactTraining,2,679,170,492,108,384,74,21,52,37,15,0
13-11-2023,Quicksilver,2,328,27,110,80,30,57,54,54,9,45,4
13-11-2023,BitterLaser,3,786,274,321,62,259,82,5,6,2,4,0
13-11-2023,Honeycomb,3,987,266,940,780,160,67,61,37,20,17,3
13-11-2023,ImpactTraining,3,173,120,124,40,84,72,14,19,17,2,0
13-12-2021,BitterLaser,2,987,206,679,219,460,72,67,56,35,21,5
13-12-2021,BitterLaser,2,348,236,238,231,7,99,62,22,9,13,1
13-12-2021,GrayPanthers,2,331,122,1,0,1,63,15,57,14,43,5
13-12-2021,Honeycomb,1,518,383,296,140,156,82,28,11,8,3,0
13-12-2021,Mustangs,1,982,164,855,782,73,96,75,19,3,16,1
13-12-2021,CelestialInterface,2,324,38,309,299,10,64,34,5,2,3,0
13-12-2021,Honeycomb,1,233,94,181,137,44,99,32,91,26,65,12
13-12-2021,Quicksilver,3,995,903,745,66,679,80,69,69,39,30,5
13-12-2021,GrayPanthers,2,112,0,101,33,68,66,65,64,34,30,4
13-12-2021,ImpactTraining,1,571,168,34,27,7,54,45,27,24,3,1
13-12-2022,Discovery,2,508,112,448,389,59,89,13,87,35,52,3
13-12-2022,PrimeSeven,3,916,308,697,383,314,84,55,79,40,39,6
13-12-2022,ImpactTraining,1,522,167,415,281,134,81,74,16,4,12,1
13-12-2022,CelestialInterface,2,410,369,281,106,175,59,40,54,17,37,3
13-12-2022,BitterLaser,2,446,185,343,153,190,63,30,54,34,20,2
13-12-2022,Aurora,3,241,172,79,3,76,79,22,35,30,5,2
13-12-2022,Aurora,3,100,8,21,17,4,85,42,80,28,52,1
13-12-2022,PrimeSeven,2,337,50,220,204,16,68,34,57,0,57,7
13-12-2022,Discovery,1,600,422,174,153,21,83,20,5,0,5,0
13-12-2022,Aurora,2,710,683,682,43,639,84,49,31,17,14,2
13-12-2023,Mustangs,2,648,346,264,170,94,56,8,13,12,1,0
13-12-2023,PrimeSeven,2,214,49,4,3,1,84,10,38,16,22,2
13-12-2023,Honeycomb,1,956,832,686,375,311,67,36,35,21,14,0
13-12-2023,CelestialInterface,2,320,273,43,19,24,91,79,40,19,21,3
13-12-2023,GrayPanthers,3,835,493,570,458,112,67,51,45,35,10,3
14-01-2021,Discovery,2,194,186,61,54,7,84,6,21,7,14,0
14-01-2021,CelestialInterface,1,315,257,294,254,40,63,30,43,14,29,0
14-01-2021,ImpactTraining,2,484,116,344,41,303,97,16,37,6,31,0
14-01-2021,Mustangs,3,562,318,342,285,57,71,16,41,29,12,4
14-01-2021,Discovery,3,651,203,411,153,258,77,9,74,47,27,4
14-01-2021,GrayPanthers,2,766,56,25,13,12,59,49,16,3,13,1
14-01-2021,Honeycomb,3,130,126,105,71,34,89,68,36,5,31,4
14-01-2021,GrayPanthers,1,885,473,245,75,170,99,90,34,8,26,0
14-01-2021,Mustangs,3,622,106,309,231,78,56,30,43,8,35,4
14-01-2022,Aurora,2,981,591,273,109,164,92,59,54,5,49,3
14-01-2022,Aurora,2,750,43,80,4,76,80,22,53,4,49,3
14-01-2022,ImpactTraining,1,295,218,16,7,9,92,76,4,1,3,0
14-01-2022,GrayPanthers,2,838,781,639,350,289,62,39,52,25,27,4
14-01-2022,Honeycomb,2,535,451,523,391,132,60,48,8,3,5,0
14-01-2022,ImpactTraining,1,704,617,541,37,504,96,23,71,53,18,2
14-01-2022,ImpactTraining,1,653,327,173,149,24,91,77,25,10,15,2
14-01-2022,ImpactTraining,2,904,82,165,110,55,50,7,12,10,2,0
14-01-2022,ImpactTraining,3,214,92,154,108,46,67,57,1,0,1,0
14-01-2022,Mustangs,2,996,534,62,22,40,60,37,24,8,16,1
14-01-2022,Discovery,1,949,440,705,532,173,97,38,1,0,1,0
14-01-2022,PrimeSeven,1,614,322,308,78,230,60,44,16,11,5,1
14-01-2023,Mustangs,2,937,762,70,42,28,86,23,58,6,52,7
14-01-2023,CelestialInterface,2,254,121,158,1,157,68,33,18,10,8,1
14-01-2023,Discovery,1,434,198,110,35,75,50,20,9,3,6,0
14-01-2023,CelestialInterface,2,945,406,540,464,76,52,33,33,20,13,1
14-01-2023,CelestialInterface,3,810,545,241,206,35,92,65,30,5,25,1
14-01-2023,ImpactTraining,1,841,630,777,365,412,67,43,21,9,12,2
14-01-2023,CelestialInterface,1,389,243,240,170,70,70,28,11,10,1,0
14-01-2023,BitterLaser,3,327,135,268,92,176,53,50,29,7,22,2
14-01-2023,Quicksilver,1,303,87,141,134,7,64,21,14,3,11,1
14-01-2023,CelestialInterface,2,127,56,17,3,14,76,42,15,5,10,0
14-01-2023,CelestialInterface,2,547,259,15,1,14,89,20,84,30,54,11
14-01-2023,BitterLaser,3,264,79,231,209,22,50,24,5,2,3,0
14-01-2023,BitterLaser,1,449,426,248,21,227,76,68,12,0,12,0
14-02-2021,BitterLaser,3,115,112,47,28,19,66,13,39,14,25,4
14-02-2021,Quicksilver,2,834,739,257,73,184,54,3,34,5,29,1
14-02-2021,Quicksilver,2,513,433,429,213,216,84,30,18,12,6,0
14-02-2021,ImpactTraining,2,693,190,212,55,157,78,53,70,25,45,7
14-02-2021,Aurora,3,987,876,600,564,36,99,6,84,64,20,6
14-02-2021,BitterLaser,1,666,147,150,121,29,63,50,31,10,21,3
14-02-2021,Aurora,2,401,46,78,73,5,60,51,59,27,32,0
14-02-2021,BitterLaser,2,818,85,432,145,287,77,47,47,18,29,0
14-02-2021,BitterLaser,1,560,119,328,10,318,77,29,69,15,54,3
14-02-2021,CelestialInterface,3,838,402,598,300,298,83,57,76,11,65,0
14-02-2022,Quicksilver,3,645,86,347,300,47,93,73,62,27,35,6
14-02-2022,BitterLaser,3,858,624,799,717,82,89,65,88,87,1,5
14-02-2022,Discovery,3,370,65,81,42,39,94,57,9,7,2,0
14-02-2022,CelestialInterface,1,849,803,378,37,341,80,8,7,2,5,0
14-02-2022,BitterLaser,3,797,172,136,1,135,82,73,63,16,47,6
14-02-2022,Aurora,1,733,507,400,272,128,68,40,45,24,21,1
14-02-2022,Mustangs,2,130,103,119,29,90,89,24,39,1,38,4
14-02-2023,GrayPanthers,1,582,85,108,37,71,58,37,20,5,15,1
14-02-2023,CelestialInterface,3,871,93,475,309,166,73,49,29,2,27,1
14-02-2023,Quicksilver,1,611,431,499,270,229,50,37,34,1,33,2
14-02-2023,Aurora,2,893,751,548,39,509,56,44,38,27,11,1
14-03-2021,Honeycomb,1,475,10,357,340,17,81,43,80,4,76,5
14-03-2021,ImpactTraining,3,799,627,750,624,126,62,46,49,12,37,0
14-03-2021,Quicksilver,1,772,145,106,97,9,54,9,6,5,1,0
14-03-2021,Aurora,1,240,55,48,27,21,96,64,9,3,6,0
14-03-2022,CelestialInterface,3,640,169,240,78,162,94,12,80,74,6,6
14-03-2022,PrimeSeven,3,547,461,318,74,244,60,41,37,8,29,1
14-03-2022,Honeycomb,2,991,282,212,86,126,90,16,85,68,17,0
14-03-2022,Discovery,3,184,151,22,19,3,84,1,78,34,44,9
14-03-2022,CelestialInterface,2,913,594,625,250,375,61,33,40,34,6,1
14-03-2022,Quicksilver,2,220,170,204,185,19,55,46,29,28,1,3
14-03-2022,ImpactTraining,2,719,716,473,61,412,94,75,81,50,31,1
14-03-2022,CelestialInterface,3,718,524,602,431,171,68,16,11,1,10,0
14-03-2022,PrimeSeven,3,641,557,360,348,12,54,5,44,2,42,0
14-03-2023,Mustangs,1,823,617,312,97,215,66,29,33,30,3,1
14-03-2023,Honeycomb,2,994,161,574,379,195,65,54,46,35,11,5
14-03-2023,Honeycomb,2,929,286,336,146,190,67,32,49,39,10,6
14-03-2023,CelestialInterface,1,203,2,49,29,20,100,1,69,28,41,6
14-03-2023,Honeycomb,3,985,32,675,376,299,90,64,62,11,51,1
14-03-2023,PrimeSeven,3,841,756,701,198,503,89,86,45,30,15,2
14-04-2021,Discovery,3,587,86,249,126,123,54,51,52,50,2,0
14-04-2021,Discovery,3,536,181,210,165,45,55,1,38,26,12,2
14-04-2021,Aurora,2,368,74,19,1,18,81,50,19,10,9,0
14-04-2021,ImpactTraining,3,181,18,93,26,67,76,4,30,29,1,2
14-04-2021,BitterLaser,3,622,576,401,276,125,77,56,16,14,2,0
14-04-2021,Honeycomb,2,465,322,303,178,125,98,52,56,5,51,3
14-04-2021,BitterLaser,3,636,548,39,38,1,62,15,38,32,6,4
14-04-2021,PrimeSeven,1,133,3,101,57,44,79,29,13,11,2,0
14-04-2022,CelestialInterface,1,896,114,657,521,136,54,24,36,1,35,2
14-04-2022,Mustangs,1,916,13,770,585,185,59,34,53,17,36,1
14-04-2022,GrayPanthers,2,972,500,526,447,79,96,62,3,0,3,0
14-04-2022,Aurora,2,270,138,236,218,18,69,19,4,1,3,0
14-04-2022,Discovery,1,925,554,914,26,888,94,35,6,5,1,0
14-04-2022,GrayPanthers,2,940,172,383,120,263,90,32,38,13,25,4
14-04-2022,GrayPanthers,1,509,257,62,57,5,73,38,56,42,14,3
14-04-2022,PrimeSeven,2,778,748,634,128,506,77,74,62,5,57,5
14-04-2022,CelestialInterface,1,497,487,27,9,18,69,68,17,13,4,1
14-04-2022,BitterLaser,2,221,6,105,71,34,51,24,43,10,33,5
14-04-2022,Discovery,2,775,660,167,42,125,60,51,47,44,3,0
14-04-2023,Aurora,3,382,113,112,40,72,55,24,52,15,37,0
14-04-2023,Discovery,3,520,174,184,102,82,92,48,90,53,37,2
14-04-2023,Honeycomb,2,769,101,286,58,228,52,7,23,20,3,0
14-04-2023,Aurora,2,352,18,170,145,25,81,15,15,1,14,1
14-04-2023,ImpactTraining,3,654,512,3,1,2,70,14,26,2,24,0
14-04-2023,Mustangs,3,197,134,142,77,65,88,83,72,38,34,7
14-04-2023,BitterLaser,3,564,534,451,167,284,64,58,54,45,9,5
14-04-2023,Honeycomb,2,723,354,17,7,10,81,65,56,8,48,3
14-04-2023,CelestialInterface,1,767,507,169,156,13,75,61,52,47,5,6
14-04-2023,CelestialInterface,1,387,351,77,25,52,53,12,37,34,3,3
14-05-2021,GrayPanthers,2,600,370,518,16,502,84,63,7,1,6,0
14-05-2021,Discovery,1,192,87,27,20,7,85,71,48,17,31,1
14-05-2021,Discovery,2,340,282,113,90,23,74,67,56,38,18,2
14-05-2021,CelestialInterface,1,441,52,86,8,78,82,9,18,3,15,1
14-05-2021,PrimeSeven,3,529,342,45,0,45,67,4,39,27,12,3
14-05-2021,Honeycomb,1,961,422,867,702,165,87,44,0,0,0,0
14-05-2021,Aurora,3,890,871,74,17,57,77,38,26,6,20,0
14-05-2021,Discovery,1,846,600,142,130,12,80,30,7,6,1,0
14-05-2021,Honeycomb,3,297,99,94,93,1,52,24,6,4,2,0
14-05-2021,GrayPanthers,1,876,740,651,107,544,89,66,58,51,7,6
14-05-2021,BitterLaser,2,440,351,384,345,39,61,58,35,28,7,2
14-05-2021,Aurora,3,609,414,209,196,13,100,98,31,29,2,2
14-05-2021,BitterLaser,3,553,382,167,75,92,98,71,31,11,20,0
14-05-2022,ImpactTraining,3,254,32,130,30,100,57,10,19,14,5,1
14-05-2022,Mustangs,3,352,226,265,173,92,95,43,74,0,74,6
14-05-2022,PrimeSeven,1,519,342,38,1,37,100,35,79,39,40,8
14-05-2022,ImpactTraining,1,825,242,571,439,132,61,32,59,49,10,4
14-05-2022,Aurora,2,982,394,302,169,133,73,27,36,11,25,3
14-05-2022,CelestialInterface,1,366,0,217,44,173,70,54,30,12,18,3
14-05-2022,Honeycomb,3,594,113,180,16,164,90,67,12,6,6,0
14-05-2022,Aurora,1,289,0,42,41,1,50,35,35,7,28,3
14-05-2022,ImpactTraining,3,228,177,33,9,24,83,73,60,22,38,5
14-05-2022,Mustangs,3,253,126,187,174,13,63,11,19,5,14,1
14-05-2022,Quicksilver,2,707,88,286,263,23,95,15,71,28,43,4
14-05-2023,Discovery,1,770,354,642,209,433,97,90,71,65,6,5
14-05-2023,Discovery,2,651,418,478,195,283,74,51,13,9,4,0
14-05-2023,Aurora,1,874,410,280,78,202,91,77,53,15,38,6
14-05-2023,Mustangs,1,131,39,130,110,20,51,37,41,35,6,3
14-06-2021,Quicksilver,3,277,246,265,180,85,65,37,16,9,7,0
14-06-2021,GrayPanthers,2,157,18,7,1,6,55,43,23,6,17,1
14-06-2021,GrayPanthers,3,250,47,83,41,42,79,46,22,2,20,1
14-06-2021,Honeycomb,3,412,368,323,122,201,56,53,36,6,30,0
14-06-2021,BitterLaser,1,669,54,411,147,264,74,23,14,1,13,0
14-06-2021,ImpactTraining,3,873,418,592,154,438,89,45,75,73,2,9
14-06-2021,PrimeSeven,3,228,158,131,76,55,85,34,65,4,61,3
14-06-2021,Mustangs,3,285,59,144,74,70,88,80,61,50,11,7
14-06-2021,PrimeSeven,2,950,431,868,317,551,80,60,39,28,11,2
14-06-2021,PrimeSeven,3,565,472,561,354,207,64,24,3,1,2,0
14-06-2022,GrayPanthers,1,381,196,186,140,46,71,8,52,10,42,4
14-06-2022,Mustangs,1,951,650,612,204,408,85,17,7,6,1,0
14-06-2022,PrimeSeven,3,363,239,224,95,129,98,76,47,29,18,4
14-06-2022,Quicksilver,1,622,119,320,278,42,80,46,77,56,21,6
14-06-2022,BitterLaser,2,809,744,243,71,172,54,53,9,2,7,0
14-06-2022,Quicksilver,3,875,505,824,260,564,83,23,77,16,61,1
14-06-2022,Aurora,2,607,202,107,82,25,50,32,11,6,5,0
14-06-2023,PrimeSeven,1,195,53,93,91,2,97,34,78,51,27,2
14-06-2023,GrayPanthers,1,897,801,341,337,4,69,51,25,22,3,1
14-06-2023,Quicksilver,1,426,343,233,35,198,65,4,2,1,1,0
14-06-2023,BitterLaser,3,274,8,65,14,51,53,39,12,9,3,0
14-06-2023,Aurora,2,787,215,517,105,412,58,30,29,16,13,0
14-06-2023,Discovery,2,584,491,451,386,65,91,22,19,0,19,0
14-06-2023,BitterLaser,1,453,44,300,216,84,72,44,46,16,30,5
14-06-2023,Honeycomb,3,879,196,453,166,287,55,44,2,1,1,0
14-07-2021,GrayPanthers,2,431,202,263,155,108,76,12,73,34,39,1
14-07-2021,BitterLaser,2,738,512,708,576,132,59,17,2,1,1,0
14-07-2021,Discovery,2,577,510,307,135,172,87,71,47,5,42,4
14-07-2021,Honeycomb,2,218,4,205,184,21,63,15,38,8,30,4
14-07-2021,Discovery,1,897,519,188,167,21,58,33,24,19,5,2
14-07-2021,ImpactTraining,2,810,86,90,28,62,94,85,37,8,29,3
14-07-2021,PrimeSeven,1,750,234,355,309,46,69,63,17,11,6,1
14-07-2021,Discovery,3,529,145,147,13,134,83,43,44,3,41,1
14-07-2021,Quicksilver,3,615,113,80,71,9,83,74,69,4,65,8
14-07-2021,BitterLaser,3,137,117,28,16,12,71,60,53,20,33,5
14-07-2021,CelestialInterface,2,327,2,269,82,187,62,39,6,5,1,0
14-07-2022,BitterLaser,1,908,692,748,743,5,73,2,17,2,15,0
14-07-2022,ImpactTraining,3,935,748,337,236,101,78,68,56,45,11,5
14-07-2022,Quicksilver,3,850,98,566,227,339,74,26,66,32,34,7
14-07-2022,BitterLaser,3,310,183,87,4,83,71,20,50,31,19,2
14-07-2022,Honeycomb,1,659,21,24,9,15,53,2,20,19,1,2
14-07-2022,Discovery,1,735,722,436,343,93,89,68,21,7,14,0
14-07-2022,Aurora,1,438,320,364,181,183,76,2,68,51,17,3
14-07-2022,GrayPanthers,1,914,502,277,86,191,97,25,1,0,1,0
14-07-2022,Aurora,2,550,32,248,212,36,91,40,21,14,7,0
14-07-2023,CelestialInterface,1,816,350,234,189,45,54,48,27,19,8,2
14-07-2023,ImpactTraining,3,945,485,319,120,199,66,55,6,4,2,0
14-07-2023,PrimeSeven,3,365,35,33,13,20,92,81,80,19,61,9
14-07-2023,Aurora,2,352,260,296,135,161,63,12,3,1,2,0
14-07-2023,Aurora,2,377,343,300,205,95,81,65,75,34,41,9
14-07-2023,ImpactTraining,1,100,27,29,22,7,94,18,4,0,4,0
14-07-2023,PrimeSeven,2,576,64,90,34,56,72,28,32,4,28,2
14-08-2021,Aurora,3,816,464,714,679,35,57,36,15,1,14,1
14-08-2021,Honeycomb,2,370,42,275,244,31,68,25,19,2,17,0
14-08-2021,Discovery,2,412,67,381,78,303,74,7,4,0,4,0
14-08-2021,Discovery,3,408,224,219,49,170,99,37,33,29,4,3
14-08-2021,ImpactTraining,1,551,548,223,132,91,64,35,47,11,36,1
14-08-2021,Quicksilver,3,239,230,121,110,11,80,60,79,51,28,5
14-08-2021,Quicksilver,3,652,403,268,78,190,92,13,68,31,37,2
14-08-2021,Honeycomb,2,352,333,14,3,11,56,39,17,5,12,0
14-08-2022,Quicksilver,1,514,422,410,205,205,67,18,58,12,46,4
14-08-2022,Quicksilver,1,475,159,217,206,11,68,11,25,14,11,2
14-08-2022,Aurora,1,919,121,86,31,55,99,87,69,58,11,2
14-08-2022,Quicksilver,3,854,605,257,81,176,81,1,32,25,7,1
14-08-2022,Discovery,1,615,447,382,120,262,88,28,25,6,19,1
14-08-2022,Honeycomb,1,370,131,112,86,26,64,2,50,41,9,4
14-08-2022,Discovery,3,392,358,323,85,238,92,54,37,18,19,4
14-08-2022,ImpactTraining,1,994,683,655,288,367,59,35,2,0,2,0
14-08-2023,CelestialInterface,1,946,831,938,533,405,73,0,54,9,45,0
14-08-2023,ImpactTraining,1,705,320,233,96,137,78,36,70,40,30,1
14-08-2023,CelestialInterface,1,705,512,628,280,348,87,17,33,26,7,2
14-08-2023,Mustangs,3,999,501,881,702,179,99,5,8,3,5,0
14-08-2023,Discovery,2,978,368,663,155,508,100,46,32,26,6,0
14-08-2023,Quicksilver,1,137,50,75,47,28,50,21,35,19,16,3
14-08-2023,Aurora,2,165,60,154,127,27,59,55,54,12,42,5
14-09-2021,Mustangs,3,388,289,346,285,61,77,4,70,11,59,3
14-09-2021,CelestialInterface,2,587,319,516,463,53,55,52,43,38,5,2
14-09-2021,Aurora,2,752,227,47,20,27,71,38,63,40,23,0
14-09-2021,Aurora,2,515,455,25,22,3,88,84,52,25,27,5
14-09-2021,Aurora,1,696,475,86,16,70,99,83,83,17,66,9
14-09-2021,Mustangs,1,225,164,139,1,138,76,68,24,6,18,1
14-09-2022,PrimeSeven,3,622,102,22,12,10,61,11,33,15,18,2
14-09-2022,Discovery,3,278,169,181,23,158,67,46,21,14,7,1
14-09-2022,Quicksilver,3,754,645,252,165,87,87,78,15,4,11,1
14-09-2022,Quicksilver,3,804,386,627,617,10,87,17,44,0,44,1
14-09-2022,Aurora,1,436,387,16,8,8,59,17,0,0,0,0
14-09-2022,Honeycomb,1,834,280,824,444,380,84,32,70,0,70,1
14-09-2022,Discovery,1,621,124,78,30,48,50,45,0,0,0,0
14-09-2022,PrimeSeven,1,194,41,129,57,72,60,6,43,18,25,4
14-09-2022,CelestialInterface,3,626,64,34,27,7,62,54,1,0,1,0
14-09-2022,BitterLaser,2,261,103,172,15,157,52,44,11,1,10,0
14-09-2022,Honeycomb,2,183,107,21,4,17,94,50,79,26,53,0
14-09-2023,Quicksilver,1,564,187,169,69,100,55,37,32,9,23,1
14-09-2023,Mustangs,1,318,200,103,97,6,90,43,35,30,5,0
14-09-2023,PrimeSeven,3,715,68,590,162,428,100,54,81,35,46,7
14-09-2023,Discovery,3,734,205,230,207,23,54,33,43,15,28,4
14-09-2023,Aurora,1,995,199,873,281,592,61,16,30,27,3,3
14-09-2023,Honeycomb,3,445,384,93,22,71,51,35,7,4,3,0
14-09-2023,Aurora,3,186,20,151,5,146,85,84,76,37,39,2
14-09-2023,Aurora,2,268,103,103,20,83,74,63,40,29,11,3
14-09-2023,ImpactTraining,1,602,413,15,3,12,54,28,47,21,26,0
14-09-2023,ImpactTraining,1,437,268,137,99,38,82,30,53,0,53,5
14-09-2023,PrimeSeven,3,855,359,712,486,226,67,22,57,12,45,4
14-09-2023,Mustangs,3,750,210,597,154,443,91,85,33,29,4,3
14-10-2021,Discovery,3,446,415,85,10,75,70,29,21,10,11,2
14-10-2021,Mustangs,3,588,582,432,46,386,59,38,3,0,3,0
14-10-2021,CelestialInterface,2,891,189,835,432,403,69,59,60,39,21,7
14-10-2021,BitterLaser,1,402,362,220,89,131,60,32,39,0,39,2
14-10-2021,Aurora,3,708,319,559,19,540,87,27,7,4,3,0
14-10-2022,Honeycomb,2,290,98,280,138,142,60,15,54,20,34,3
14-10-2022,Mustangs,2,189,51,109,22,87,82,48,67,5,62,9
14-10-2022,Honeycomb,3,505,398,394,252,142,52,6,46,4,42,4
14-10-2022,ImpactTraining,3,239,102,62,55,7,97,24,41,0,41,0
14-10-2022,Mustangs,2,906,27,417,159,258,74,47,28,6,22,0
14-10-2022,CelestialInterface,2,249,2,116,93,23,82,37,36,20,16,0
14-10-2022,Honeycomb,3,330,30,197,163,34,80,60,69,67,2,9
14-10-2022,ImpactTraining,3,985,624,297,218,79,60,33,28,4,24,0
14-10-2022,Aurora,2,598,55,455,405,50,76,6,50,18,32,3
14-10-2022,ImpactTraining,3,487,458,349,8,341,65,10,54,6,48,1
14-10-2023,Aurora,3,344,121,152,87,65,69,27,25,15,10,2
14-10-2023,ImpactTraining,3,424,69,0,0,0,63,60,59,58,1,1
14-10-2023,ImpactTraining,1,667,392,157,73,84,65,26,62,35,27,4
14-10-2023,Mustangs,3,842,164,182,150,32,60,21,3,0,3,0
14-10-2023,Honeycomb,1,879,81,524,360,164,92,34,12,5,7,0
14-10-2023,Discovery,1,138,137,112,75,37,62,50,8,2,6,0
14-11-2021,Quicksilver,3,809,755,575,396,179,89,70,0,0,0,0
14-11-2021,PrimeSeven,3,958,684,746,325,421,60,27,52,23,29,0
14-11-2021,Mustangs,1,136,2,1,0,1,80,10,40,23,17,5
14-11-2021,Honeycomb,3,422,143,118,44,74,91,10,84,48,36,8
14-11-2021,Aurora,2,418,97,108,63,45,94,83,3,2,1,0
14-11-2021,Aurora,3,913,482,136,40,96,54,2,39,36,3,4
14-11-2021,Aurora,1,701,9,265,42,223,89,29,53,16,37,4
14-11-2021,Aurora,2,147,33,83,73,10,58,15,29,2,27,1
14-11-2021,CelestialInterface,2,719,130,32,3,29,50,33,40,25,15,1
14-11-2021,GrayPanthers,1,107,59,97,33,64,91,63,30,6,24,3
14-11-2021,Honeycomb,1,318,30,114,55,59,72,39,45,10,35,0
14-11-2021,Mustangs,3,802,485,491,105,386,98,92,57,53,4,5
14-11-2021,PrimeSeven,2,353,174,122,93,29,87,60,51,9,42,6
14-11-2021,PrimeSeven,3,627,614,446,186,260,94,13,23,16,7,1
14-11-2022,PrimeSeven,1,631,601,323,101,222,59,18,33,2,31,2
14-11-2022,PrimeSeven,2,393,69,381,68,313,78,32,54,36,18,1
14-11-2022,Aurora,1,107,19,16,3,13,70,36,11,8,3,0
14-11-2022,ImpactTraining,2,641,544,447,396,51,77,10,57,34,23,3
14-11-2022,ImpactTraining,1,612,142,1,0,1,77,53,42,23,19,5
14-11-2022,Aurora,1,470,382,193,136,57,79,68,22,19,3,2
14-11-2022,BitterLaser,3,882,212,64,9,55,53,6,44,36,8,5
14-11-2022,BitterLaser,3,319,8,7,1,6,61,54,5,3,2,0
14-11-2023,Discovery,1,123,103,5,4,1,64,39,19,11,8,1
14-11-2023,Aurora,2,716,117,337,273,64,67,10,64,5,59,7
14-11-2023,CelestialInterface,1,923,583,742,597,145,98,5,48,10,38,2
14-11-2023,Mustangs,2,422,237,96,68,28,61,8,54,7,47,1
14-11-2023,Aurora,1,978,243,801,598,203,59,19,7,6,1,0
14-11-2023,Quicksilver,1,807,242,156,129,27,100,4,41,8,33,5
14-11-2023,BitterLaser,2,191,126,142,125,17,60,13,46,24,22,1
14-11-2023,GrayPanthers,2,728,570,96,7,89,95,59,65,0,65,2
14-11-2023,Mustangs,1,236,152,206,142,64,68,17,32,9,23,3
14-11-2023,Mustangs,2,501,48,16,11,5,97,63,26,8,18,1
14-11-2023,Honeycomb,2,196,184,176,119,57,92,18,9,4,5,0
14-12-2021,ImpactTraining,2,610,570,543,414,129,71,40,12,2,10,0
14-12-2021,BitterLaser,3,230,202,155,87,68,55,22,19,11,8,0
14-12-2021,GrayPanthers,2,411,348,157,76,81,81,63,11,8,3,0
14-12-2021,Aurora,1,706,229,321,143,178,67,48,26,19,7,1
14-12-2021,Honeycomb,3,268,182,260,54,206,52,37,6,4,2,0
14-12-2022,CelestialInterface,3,243,149,20,7,13,95,94,73,2,71,0
14-12-2022,Mustangs,1,515,205,117,27,90,68,16,36,27,9,0
14-12-2022,Honeycomb,2,736,29,590,574,16,66,41,64,52,12,3
14-12-2022,PrimeSeven,1,378,358,56,6,50,66,39,47,37,10,0
14-12-2022,CelestialInterface,2,245,120,107,77,30,81,65,46,20,26,1
14-12-2022,Quicksilver,3,881,283,22,11,11,70,36,1,0,1,0
14-12-2022,Quicksilver,2,681,111,677,664,13,64,4,0,0,0,0
14-12-2022,Quicksilver,3,800,276,75,2,73,53,31,36,22,14,0
14-12-2022,Mustangs,1,768,212,367,243,124,57,52,7,6,1,0
14-12-2023,BitterLaser,1,284,196,202,173,29,53,35,51,21,30,6
14-12-2023,Aurora,3,411,180,1,0,1,61,54,27,17,10,2
14-12-2023,BitterLaser,3,432,205,255,9,246,88,40,87,74,13,6
14-12-2023,Mustangs,1,553,426,380,91,289,50,39,39,25,14,3
14-12-2023,PrimeSeven,2,772,187,78,1,77,72,0,64,37,27,6
14-12-2023,Discovery,3,858,574,133,102,31,85,11,6,4,2,0
14-12-2023,Discovery,2,927,775,864,556,308,52,39,4,2,2,0
14-12-2023,Mustangs,2,205,103,127,81,46,75,53,38,8,30,3
14-12-2023,PrimeSeven,1,374,81,186,105,81,70,36,49,14,35,3
14-12-2023,Mustangs,2,289,49,96,47,49,96,89,85,37,48,7
14-12-2023,ImpactTraining,2,849,610,541,44,497,61,14,15,12,3,0
15-01-2021,Discovery,3,265,153,146,26,120,85,28,61,13,48,8
15-01-2021,Quicksilver,1,654,308,259,225,34,79,53,36,22,14,3
15-01-2021,Mustangs,2,482,83,465,146,319,100,11,5,3,2,0
15-01-2021,ImpactTraining,2,525,400,210,143,67,79,66,18,9,9,1
15-01-2021,GrayPanthers,2,414,370,329,0,329,76,46,43,8,35,0
15-01-2022,Honeycomb,3,749,86,546,429,117,63,25,34,1,33,1
15-01-2022,Aurora,1,706,66,210,171,39,79,1,44,13,31,3
15-01-2022,BitterLaser,3,239,130,208,19,189,77,47,70,51,19,0
15-01-2022,ImpactTraining,1,316,192,310,274,36,80,32,73,33,40,1
15-01-2022,BitterLaser,3,719,298,149,39,110,90,25,42,6,36,2
15-01-2022,Mustangs,3,693,232,540,146,394,60,18,55,43,12,5
15-01-2022,Honeycomb,1,310,104,169,116,53,58,9,25,19,6,2
15-01-2022,BitterLaser,3,725,309,484,264,220,64,34,39,37,2,3
15-01-2022,CelestialInterface,2,805,267,666,230,436,89,79,12,1,11,0
15-01-2022,GrayPanthers,2,696,336,101,91,10,88,85,52,4,48,1
15-01-2022,Aurora,3,362,142,265,65,200,89,2,3,1,2,0
15-01-2022,BitterLaser,1,141,50,55,54,1,82,31,47,3,44,5
15-01-2022,GrayPanthers,2,112,2,32,28,4,90,48,63,26,37,8
15-01-2023,Discovery,2,884,472,520,193,327,90,56,81,58,23,4
15-01-2023,BitterLaser,2,276,186,171,87,84,52,44,46,2,44,5
15-01-2023,Mustangs,2,999,101,912,275,637,54,53,16,11,5,1
15-01-2023,ImpactTraining,1,400,288,294,138,156,52,9,1,0,1,0
15-01-2023,Discovery,3,174,82,134,122,12,52,33,0,0,0,0
15-01-2023,Mustangs,1,345,131,123,100,23,82,8,11,1,10,0
15-02-2021,PrimeSeven,3,254,165,158,19,139,59,20,12,11,1,0
15-02-2021,Mustangs,2,373,303,147,21,126,52,4,51,13,38,4
15-02-2021,PrimeSeven,2,696,509,565,57,508,81,63,73,5,68,4
15-02-2021,Quicksilver,1,215,122,110,63,47,77,32,65,49,16,4
15-02-2021,Aurora,2,943,584,65,10,55,89,58,70,49,21,2
15-02-2021,CelestialInterface,1,393,277,220,55,165,65,27,16,14,2,1
15-02-2021,BitterLaser,1,610,313,345,292,53,76,32,54,33,21,6
15-02-2021,CelestialInterface,3,889,759,672,613,59,79,20,54,51,3,3
15-02-2021,ImpactTraining,2,708,132,575,558,17,59,14,32,2,30,0
15-02-2021,PrimeSeven,3,244,48,213,51,162,76,25,40,16,24,4
15-02-2021,PrimeSeven,3,742,249,641,261,380,82,76,35,9,26,3
15-02-2021,CelestialInterface,2,731,412,521,78,443,79,30,3,0,3,0
15-02-2022,CelestialInterface,1,898,193,652,222,430,84,56,44,9,35,3
15-02-2022,Honeycomb,3,140,64,23,18,5,98,32,86,13,73,8
15-02-2022,Mustangs,3,467,181,413,141,272,66,35,28,4,24,3
15-02-2022,Aurora,2,476,142,277,201,76,72,63,71,4,67,4
15-02-2022,PrimeSeven,2,562,549,367,57,310,53,49,5,1,4,0
15-02-2022,Aurora,2,358,256,80,4,76,90,55,86,3,83,9
15-02-2022,Honeycomb,2,542,298,461,89,372,74,13,25,14,11,0
15-02-2022,Mustangs,3,980,974,476,440,36,50,23,3,0,3,0
15-02-2022,BitterLaser,2,266,222,196,169,27,82,52,10,2,8,0
15-02-2022,GrayPanthers,1,881,327,843,674,169,94,55,54,48,6,6
15-02-2023,PrimeSeven,3,798,421,299,278,21,73,27,53,50,3,1
15-02-2023,Mustangs,3,254,100,37,13,24,62,43,1,0,1,0
15-02-2023,BitterLaser,1,125,91,100,37,63,100,96,37,22,15,2
15-02-2023,PrimeSeven,1,667,280,342,2,340,51,42,17,12,5,1
15-02-2023,BitterLaser,2,557,125,71,30,41,88,53,50,43,7,1
15-02-2023,Aurora,1,902,188,213,92,121,83,30,64,8,56,6
15-03-2021,Aurora,2,671,613,642,180,462,66,58,25,3,22,1
15-03-2021,PrimeSeven,3,514,156,282,148,134,92,11,29,23,6,0
15-03-2021,Honeycomb,3,192,67,34,11,23,74,19,53,11,42,3
15-03-2021,GrayPanthers,3,927,421,390,170,220,86,62,28,7,21,0
15-03-2021,PrimeSeven,2,295,195,129,104,25,100,69,98,6,92,1
15-03-2021,Discovery,3,737,486,52,43,9,85,39,30,6,24,2
15-03-2022,PrimeSeven,3,425,135,369,226,143,82,47,79,39,40,7
15-03-2022,GrayPanthers,3,245,17,48,12,36,82,4,15,6,9,0
15-03-2022,PrimeSeven,1,787,579,362,5,357,68,25,37,15,22,3
15-03-2022,CelestialInterface,1,836,611,639,341,298,71,61,29,21,8,1
15-03-2022,GrayPanthers,3,290,217,82,27,55,91,62,4,3,1,0
15-03-2022,Aurora,3,849,158,742,610,132,54,19,3,1,2,0
15-03-2022,Mustangs,2,460,240,420,347,73,72,53,58,39,19,0
15-03-2022,ImpactTraining,3,844,50,765,602,163,74,70,22,20,2,1
15-03-2022,GrayPanthers,1,717,703,12,6,6,61,1,44,31,13,3
15-03-2022,CelestialInterface,3,856,502,395,94,301,59,14,3,2,1,0
15-03-2022,Honeycomb,1,406,136,164,135,29,64,48,44,26,18,0
15-03-2022,BitterLaser,3,417,262,342,11,331,76,41,19,4,15,0
15-03-2022,Quicksilver,2,951,698,642,77,565,90,12,64,17,47,4
15-03-2022,Quicksilver,2,476,87,131,8,123,65,30,47,37,10,0
15-03-2023,Aurora,1,826,19,39,13,26,62,42,22,15,7,0
15-03-2023,BitterLaser,1,515,193,276,28,248,75,4,8,1,7,0
15-03-2023,PrimeSeven,2,796,95,316,192,124,71,12,0,0,0,0
15-03-2023,GrayPanthers,2,761,269,353,257,96,74,19,52,8,44,2
15-03-2023,PrimeSeven,1,188,116,139,28,111,94,4,44,25,19,4
15-03-2023,ImpactTraining,2,654,304,288,251,37,100,20,78,58,20,2
15-03-2023,Discovery,2,737,29,207,75,132,55,15,15,2,13,1
15-03-2023,GrayPanthers,2,570,31,475,182,293,75,24,59,57,2,1
15-03-2023,BitterLaser,1,659,246,372,297,75,85,1,49,0,49,5
15-03-2023,PrimeSeven,2,172,36,69,61,8,82,67,53,36,17,0
15-03-2023,Quicksilver,2,691,124,622,143,479,65,31,17,15,2,1
15-04-2021,Discovery,2,997,983,423,235,188,52,7,41,23,18,4
15-04-2021,CelestialInterface,2,288,78,52,2,50,56,36,24,19,5,2
15-04-2021,Mustangs,2,309,4,104,45,59,77,62,61,8,53,3
15-04-2021,Quicksilver,3,755,385,366,164,202,83,80,70,51,19,1
15-04-2021,PrimeSeven,1,870,281,73,71,2,50,14,16,6,10,0
15-04-2021,BitterLaser,2,466,419,436,173,263,96,80,58,33,25,4
15-04-2021,BitterLaser,1,557,362,272,267,5,67,31,38,22,16,0
15-04-2021,CelestialInterface,2,707,254,200,193,7,79,24,62,16,46,6
15-04-2021,Aurora,3,809,370,517,324,193,95,27,58,32,26,3
15-04-2021,BitterLaser,1,662,472,521,134,387,88,69,1,0,1,0
15-04-2021,Mustangs,3,481,38,13,5,8,58,43,6,2,4,0
15-04-2021,Aurora,2,649,136,347,58,289,61,48,32,15,17,0
15-04-2021,PrimeSeven,2,162,150,121,45,76,89,13,82,62,20,4
15-04-2022,Quicksilver,1,397,169,265,133,132,60,46,58,24,34,4
15-04-2022,Aurora,1,312,139,250,47,203,51,6,27,23,4,2
15-04-2022,CelestialInterface,3,641,576,460,225,235,79,4,10,2,8,0
15-04-2022,ImpactTraining,3,791,599,14,4,10,76,15,53,18,35,4
15-04-2022,PrimeSeven,3,483,108,250,113,137,99,42,29,3,26,1
15-04-2022,BitterLaser,1,215,48,113,78,35,69,55,63,17,46,0
15-04-2022,ImpactTraining,3,512,509,75,43,32,96,89,45,39,6,2
15-04-2023,Discovery,1,843,550,346,92,254,77,71,46,25,21,0
15-04-2023,GrayPanthers,2,611,512,442,85,357,76,50,28,26,2,2
15-04-2023,Quicksilver,2,797,111,63,18,45,50,19,3,1,2,0
15-04-2023,PrimeSeven,3,995,564,770,390,380,70,29,62,17,45,0
15-04-2023,Quicksilver,2,506,331,84,35,49,62,54,44,10,34,1
15-04-2023,Aurora,2,204,59,151,146,5,50,26,15,1,14,0
15-04-2023,CelestialInterface,3,142,103,61,43,18,98,22,30,18,12,1
15-04-2023,Quicksilver,3,223,194,171,160,11,54,36,13,5,8,0
15-04-2023,BitterLaser,3,164,155,131,27,104,82,11,33,11,22,0
15-04-2023,BitterLaser,2,646,172,42,41,1,84,61,79,71,8,7
15-05-2021,GrayPanthers,1,888,596,514,147,367,81,33,77,8,69,2
15-05-2021,Mustangs,1,228,146,133,51,82,59,38,12,4,8,0
15-05-2021,BitterLaser,1,690,188,678,433,245,58,28,44,23,21,4
15-05-2021,PrimeSeven,2,529,396,153,69,84,83,33,75,62,13,9
15-05-2021,Quicksilver,3,230,129,117,57,60,80,70,26,12,14,1
15-05-2021,Discovery,3,547,433,364,191,173,70,25,35,10,25,0
15-05-2021,BitterLaser,3,327,35,125,121,4,63,16,28,21,7,1
15-05-2021,Discovery,2,586,398,244,180,64,72,49,59,22,37,2
15-05-2021,ImpactTraining,3,170,62,7,1,6,92,28,35,5,30,0
15-05-2021,Mustangs,1,437,372,178,90,88,89,63,58,4,54,6
15-05-2022,PrimeSeven,1,113,79,95,25,70,59,8,3,2,1,0
15-05-2022,Mustangs,3,457,214,299,86,213,92,45,36,27,9,1
15-05-2022,Honeycomb,2,648,365,362,23,339,75,28,43,11,32,5
15-05-2022,Mustangs,2,800,19,748,622,126,58,34,34,4,30,0
15-05-2022,Quicksilver,3,213,207,21,17,4,94,61,90,0,90,3
15-05-2022,Honeycomb,1,104,2,102,35,67,67,5,39,4,35,2
15-05-2022,CelestialInterface,3,902,677,524,208,316,92,2,38,3,35,2
15-05-2023,Honeycomb,1,963,447,342,4,338,50,17,6,3,3,0
15-05-2023,Aurora,3,454,279,424,240,184,78,76,48,2,46,6
15-05-2023,Discovery,2,216,135,67,62,5,67,56,13,11,2,0
15-05-2023,ImpactTraining,3,206,59,17,0,17,74,61,20,13,7,0
15-05-2023,Quicksilver,2,312,83,16,12,4,86,32,19,4,15,0
15-05-2023,CelestialInterface,2,945,582,926,41,885,96,31,91,46,45,0
15-05-2023,GrayPanthers,2,279,221,120,96,24,79,42,2,1,1,0
15-05-2023,Honeycomb,1,667,193,595,178,417,61,60,27,3,24,1
15-05-2023,ImpactTraining,3,122,1,50,38,12,67,42,65,23,42,5
15-05-2023,BitterLaser,3,964,123,317,195,122,78,14,74,18,56,9
15-06-2021,PrimeSeven,1,978,809,497,69,428,97,58,27,1,26,0
15-06-2021,Aurora,2,527,349,143,100,43,83,56,13,10,3,0
15-06-2021,Mustangs,2,309,77,218,197,21,93,65,51,24,27,2
15-06-2021,BitterLaser,1,316,264,92,56,36,89,4,73,34,39,8
15-06-2021,Mustangs,2,334,18,68,58,10,93,29,46,23,23,5
15-06-2021,Mustangs,3,584,564,359,2,357,93,78,59,52,7,0
15-06-2021,Mustangs,1,221,203,178,142,36,85,84,19,12,7,1
15-06-2021,CelestialInterface,2,717,399,596,430,166,68,62,36,9,27,3
15-06-2022,PrimeSeven,2,917,576,707,211,496,60,47,5,0,5,0
15-06-2022,Discovery,1,402,397,390,273,117,50,4,37,30,7,1
15-06-2022,Quicksilver,1,239,90,115,33,82,76,24,66,45,21,4
15-06-2022,PrimeSeven,1,200,75,153,11,142,60,13,4,1,3,0
15-06-2022,Discovery,2,617,329,55,47,8,50,47,43,34,9,4
15-06-2022,BitterLaser,3,916,13,478,45,433,94,18,19,12,7,0
15-06-2022,Discovery,2,531,101,14,9,5,83,47,50,13,37,5
15-06-2022,Discovery,3,722,310,696,636,60,87,38,31,27,4,1
15-06-2023,Aurora,3,981,390,542,442,100,83,80,44,23,21,0
15-06-2023,BitterLaser,2,814,275,193,134,59,81,17,55,54,1,3
15-06-2023,CelestialInterface,1,555,114,153,123,30,56,36,33,32,1,3
15-06-2023,GrayPanthers,2,909,37,335,294,41,63,42,22,17,5,0
15-06-2023,ImpactTraining,1,724,457,584,333,251,77,68,8,6,2,0
15-06-2023,Aurora,3,129,12,108,69,39,85,2,50,31,19,6
15-06-2023,BitterLaser,3,655,8,458,287,171,99,24,71,13,58,0
15-07-2021,GrayPanthers,1,829,562,273,221,52,66,25,45,4,41,5
15-07-2021,Mustangs,2,493,292,472,377,95,95,16,61,8,53,7
15-07-2021,Quicksilver,3,537,430,435,56,379,64,12,9,1,8,0
15-07-2021,GrayPanthers,2,533,524,242,124,118,55,18,20,6,14,2
15-07-2021,BitterLaser,1,423,396,45,41,4,94,79,29,5,24,1
15-07-2021,BitterLaser,1,446,98,140,48,92,71,53,11,8,3,0
15-07-2021,Mustangs,3,502,471,258,211,47,78,0,50,46,4,6
15-07-2021,ImpactTraining,3,564,142,500,302,198,100,33,89,62,27,4
15-07-2021,CelestialInterface,1,158,150,98,27,71,50,40,48,33,15,3
15-07-2022,Aurora,2,284,130,70,48,22,92,84,47,22,25,0
15-07-2022,ImpactTraining,2,890,671,384,345,39,86,42,55,21,34,5
15-07-2022,CelestialInterface,3,747,627,92,67,25,100,29,40,30,10,3
15-07-2022,BitterLaser,1,722,451,113,65,48,58,11,3,0,3,0
15-07-2022,Discovery,2,753,733,653,611,42,81,27,44,41,3,0
15-07-2022,PrimeSeven,3,501,352,428,322,106,89,39,77,26,51,1
15-07-2023,BitterLaser,3,148,125,145,43,102,96,68,16,14,2,1
15-07-2023,Honeycomb,2,841,465,29,18,11,96,68,46,24,22,4
15-07-2023,Discovery,3,709,544,559,236,323,68,17,10,5,5,0
15-07-2023,Quicksilver,1,464,306,291,39,252,55,30,54,26,28,3
15-07-2023,GrayPanthers,2,713,522,234,164,70,51,34,13,8,5,0
15-07-2023,Discovery,1,823,124,252,64,188,84,44,60,1,59,8
15-07-2023,Mustangs,1,954,48,373,206,167,64,39,36,9,27,2
15-07-2023,CelestialInterface,3,591,14,270,161,109,58,56,55,45,10,7
15-08-2021,ImpactTraining,3,948,207,309,122,187,61,43,15,9,6,1
15-08-2021,Quicksilver,1,376,288,371,305,66,71,7,32,22,10,1
15-08-2021,Quicksilver,1,685,198,203,118,85,73,72,52,4,48,6
15-08-2021,CelestialInterface,1,381,278,283,41,242,88,71,26,2,24,0
15-08-2021,ImpactTraining,2,173,104,47,29,18,69,38,48,36,12,1
15-08-2021,Discovery,3,859,375,534,219,315,75,11,39,24,15,3
15-08-2021,Mustangs,3,794,200,542,295,247,60,12,16,7,9,0
15-08-2021,Quicksilver,1,319,154,133,86,47,74,19,71,49,22,0
15-08-2021,ImpactTraining,3,439,395,192,180,12,60,57,54,27,27,2
15-08-2022,Aurora,3,475,445,365,191,174,54,27,26,23,3,2
15-08-2022,PrimeSeven,2,715,581,394,55,339,57,22,53,32,21,3
15-08-2022,GrayPanthers,1,401,154,39,21,18,53,12,40,13,27,3
15-08-2023,GrayPanthers,1,986,194,671,443,228,65,4,46,31,15,3
15-08-2023,PrimeSeven,2,386,256,348,347,1,77,12,16,11,5,1
15-08-2023,ImpactTraining,3,505,38,297,124,173,71,15,67,64,3,8
15-08-2023,Honeycomb,2,750,336,736,543,193,92,2,17,11,6,1
15-08-2023,Discovery,1,607,34,530,246,284,79,39,40,22,18,0
15-08-2023,Discovery,3,760,332,689,318,371,88,9,58,14,44,7
15-08-2023,Mustangs,1,193,172,104,94,10,50,38,40,7,33,3
15-09-2021,CelestialInterface,3,228,136,164,56,108,76,65,55,17,38,5
15-09-2021,ImpactTraining,1,620,278,229,81,148,98,91,44,34,10,2
15-09-2021,GrayPanthers,1,310,287,233,205,28,81,18,9,6,3,0
15-09-2021,BitterLaser,1,135,126,83,17,66,100,19,83,47,36,3
15-09-2021,CelestialInterface,3,969,758,500,138,362,61,6,39,36,3,4
15-09-2021,PrimeSeven,1,519,278,263,207,56,73,21,13,5,8,0
15-09-2021,Discovery,1,555,409,355,198,157,99,29,34,18,16,3
15-09-2021,Discovery,3,240,100,161,159,2,60,25,7,1,6,0
15-09-2022,GrayPanthers,2,654,251,108,99,9,94,23,35,20,15,2
15-09-2022,CelestialInterface,2,195,25,161,27,134,84,26,37,16,21,1
15-09-2022,Quicksilver,2,328,242,102,43,59,59,34,22,12,10,2
15-09-2022,PrimeSeven,1,279,73,262,86,176,95,60,63,12,51,1
15-09-2022,Discovery,2,676,580,372,306,66,90,57,26,9,17,2
15-09-2022,Aurora,2,651,389,323,79,244,60,49,9,6,3,0
15-09-2022,Discovery,2,148,86,84,52,32,53,4,27,17,10,3
15-09-2022,Mustangs,2,624,40,291,231,60,71,49,27,1,26,1
15-09-2022,ImpactTraining,3,253,59,138,97,41,70,0,44,34,10,5
15-09-2022,ImpactTraining,3,323,238,37,3,34,87,8,12,6,6,0
15-09-2023,BitterLaser,1,206,60,173,26,147,87,45,55,42,13,5
15-09-2023,Honeycomb,2,384,271,77,7,70,52,30,19,2,17,1
15-09-2023,ImpactTraining,3,185,6,119,114,5,84,45,60,5,55,7
15-09-2023,GrayPanthers,2,514,463,311,226,85,78,56,51,44,7,5
15-09-2023,GrayPanthers,1,749,627,361,309,52,94,55,39,11,28,1
15-10-2021,Honeycomb,2,206,164,139,15,124,69,41,53,38,15,6
15-10-2021,ImpactTraining,2,105,89,96,53,43,90,47,45,22,23,4
15-10-2021,PrimeSeven,1,760,728,517,198,319,52,25,30,3,27,3
15-10-2021,ImpactTraining,3,819,637,10,4,6,70,6,29,12,17,0
15-10-2021,PrimeSeven,1,951,830,726,309,417,70,11,46,13,33,0
15-10-2021,PrimeSeven,1,398,87,356,6,350,83,17,1,0,1,0
15-10-2022,Quicksilver,1,814,105,710,371,339,85,6,65,54,11,5
15-10-2022,Mustangs,2,942,773,146,29,117,79,76,12,10,2,0
15-10-2022,BitterLaser,1,513,64,445,242,203,100,39,86,29,57,0
15-10-2022,Discovery,2,459,273,253,123,130,70,64,28,2,26,2
15-10-2022,ImpactTraining,2,983,570,386,240,146,70,9,68,58,10,7
15-10-2022,Honeycomb,3,819,360,719,296,423,79,59,74,8,66,7
15-10-2022,Honeycomb,1,459,71,173,99,74,95,79,52,16,36,0
15-10-2022,BitterLaser,2,942,272,46,45,1,91,39,26,4,22,0
15-10-2022,Honeycomb,2,521,227,251,107,144,92,57,27,11,16,2
15-10-2022,Mustangs,3,631,534,576,69,507,85,25,39,32,7,1
15-10-2022,Discovery,2,509,371,262,82,180,52,43,29,13,16,0
15-10-2023,Honeycomb,1,199,162,107,49,58,83,1,15,0,15,1
15-10-2023,ImpactTraining,1,802,408,675,141,534,53,8,4,0,4,0
15-10-2023,GrayPanthers,2,944,782,517,359,158,88,67,83,46,37,3
15-10-2023,Mustangs,1,460,363,375,347,28,78,55,63,23,40,7
15-10-2023,Aurora,3,778,232,80,20,60,68,4,2,1,1,0
15-10-2023,Discovery,3,622,598,57,12,45,63,62,11,6,5,0
15-10-2023,Discovery,1,242,163,204,145,59,80,18,15,1,14,1
15-11-2021,Quicksilver,2,156,22,3,1,2,74,1,12,4,8,0
15-11-2021,Aurora,1,579,358,5,0,5,80,43,40,3,37,5
15-11-2021,GrayPanthers,2,138,68,58,19,39,67,37,51,17,34,0
15-11-2021,GrayPanthers,3,339,40,304,142,162,71,11,46,17,29,0
15-11-2021,Aurora,2,157,117,146,92,54,71,57,14,6,8,1
15-11-2021,GrayPanthers,3,565,66,227,111,116,68,18,28,10,18,1
15-11-2021,Quicksilver,3,749,322,17,14,3,77,66,9,2,7,0
15-11-2021,Aurora,2,143,103,113,77,36,75,57,33,31,2,1
15-11-2021,GrayPanthers,1,868,101,62,29,33,58,39,23,11,12,0
15-11-2021,CelestialInterface,3,127,39,84,0,84,72,14,57,10,47,1
15-11-2021,PrimeSeven,2,730,64,278,9,269,88,48,86,34,52,11
15-11-2022,PrimeSeven,2,769,649,393,279,114,97,60,89,53,36,0
15-11-2022,Discovery,3,968,473,923,588,335,71,0,15,7,8,0
15-11-2022,Mustangs,3,269,103,7,6,1,87,20,4,1,3,0
15-11-2022,ImpactTraining,2,809,40,250,249,1,98,72,12,7,5,0
15-11-2022,Honeycomb,3,968,606,22,0,22,84,62,18,10,8,1
15-11-2022,ImpactTraining,2,699,490,330,201,129,63,42,61,11,50,7
15-11-2022,GrayPanthers,1,505,338,130,101,29,78,75,6,3,3,0
15-11-2022,PrimeSeven,2,655,382,645,7,638,94,64,16,3,13,0
15-11-2022,Honeycomb,1,954,350,273,162,111,78,49,45,7,38,5
15-11-2022,Discovery,1,162,19,56,54,2,98,70,8,7,1,0
15-11-2023,PrimeSeven,2,487,179,178,73,105,54,18,1,0,1,0
15-11-2023,Quicksilver,3,327,1,224,83,141,75,44,74,35,39,10
15-11-2023,CelestialInterface,2,708,393,283,145,138,52,41,37,13,24,0
15-11-2023,Honeycomb,1,645,52,424,422,2,66,8,18,7,11,1
15-11-2023,Quicksilver,1,211,157,157,100,57,68,13,33,21,12,2
15-11-2023,Quicksilver,3,380,70,149,86,63,63,14,1,0,1,0
15-11-2023,ImpactTraining,3,984,643,307,143,164,67,55,27,10,17,0
15-11-2023,GrayPanthers,3,636,354,92,27,65,63,47,42,38,4,3
15-11-2023,GrayPanthers,3,120,22,52,36,16,61,48,11,1,10,0
15-12-2021,Mustangs,2,527,69,151,92,59,80,33,56,48,8,0
15-12-2021,Discovery,1,845,127,507,253,254,99,46,30,5,25,3
15-12-2021,Honeycomb,1,492,387,222,160,62,95,35,59,39,20,0
15-12-2021,PrimeSeven,3,286,193,114,12,102,62,53,37,26,11,3
15-12-2021,CelestialInterface,1,620,436,153,36,117,60,18,5,2,3,0
15-12-2021,Aurora,2,567,186,85,8,77,70,62,62,42,20,5
15-12-2021,GrayPanthers,3,182,120,71,12,59,100,45,86,33,53,3
15-12-2021,Quicksilver,1,271,188,207,146,61,61,13,54,10,44,5
15-12-2021,CelestialInterface,1,357,327,264,196,68,77,34,11,1,10,0
15-12-2021,GrayPanthers,3,370,78,336,86,250,95,82,94,3,91,11
15-12-2021,CelestialInterface,1,849,37,44,37,7,97,45,17,1,16,1
15-12-2021,GrayPanthers,1,391,377,128,127,1,97,34,54,39,15,0
15-12-2021,BitterLaser,3,787,134,394,306,88,83,56,12,2,10,0
15-12-2022,PrimeSeven,1,535,320,267,63,204,78,47,7,3,4,0
15-12-2022,Honeycomb,2,556,426,264,21,243,86,9,51,27,24,2
15-12-2022,Mustangs,3,781,378,199,75,124,79,44,72,69,3,3
15-12-2022,Honeycomb,3,533,451,417,277,140,92,25,28,15,13,0
15-12-2023,BitterLaser,1,735,363,37,33,4,88,19,25,6,19,0
15-12-2023,Quicksilver,2,750,503,216,207,9,80,76,72,17,55,0
15-12-2023,Honeycomb,3,608,513,13,8,5,81,51,76,34,42,10
15-12-2023,ImpactTraining,2,460,410,104,65,39,57,13,17,9,8,1
15-12-2023,Quicksilver,3,721,27,451,279,172,77,61,43,0,43,4
15-12-2023,ImpactTraining,2,441,412,382,264,118,93,38,8,1,7,0
15-12-2023,PrimeSeven,2,936,554,225,196,29,62,49,9,5,4,0
15-12-2023,Honeycomb,2,842,604,798,149,649,75,63,40,8,32,2
15-12-2023,BitterLaser,2,564,191,33,14,19,85,74,45,5,40,5
15-12-2023,Quicksilver,2,734,530,237,75,162,74,42,30,18,12,0
15-12-2023,Honeycomb,1,838,102,367,53,314,58,49,26,19,7,0
16-01-2021,BitterLaser,1,400,285,230,181,49,82,75,69,15,54,2
16-01-2021,Quicksilver,3,328,183,172,151,21,65,6,61,60,1,4
16-01-2021,Quicksilver,2,581,46,369,5,364,77,51,23,21,2,2
16-01-2021,GrayPanthers,1,381,298,159,87,72,56,0,39,15,24,0
16-01-2021,Aurora,1,294,11,26,6,20,78,64,33,1,32,0
16-01-2021,CelestialInterface,3,614,578,472,411,61,80,29,53,33,20,4
16-01-2021,Mustangs,3,968,602,1,0,1,67,63,47,11,36,3
16-01-2021,Quicksilver,1,428,258,125,21,104,69,45,64,27,37,7
16-01-2021,Honeycomb,1,541,398,139,56,83,61,39,28,19,9,1
16-01-2021,GrayPanthers,1,654,161,628,408,220,52,50,11,7,4,0
16-01-2021,Honeycomb,3,653,310,348,256,92,82,79,62,8,54,5
16-01-2022,PrimeSeven,1,997,585,810,20,790,95,65,19,0,19,1
16-01-2022,Honeycomb,1,453,226,99,16,83,84,13,72,13,59,5
16-01-2022,BitterLaser,1,535,188,1,0,1,72,17,44,2,42,3
16-01-2022,ImpactTraining,3,867,506,266,185,81,86,24,37,7,30,1
16-01-2022,BitterLaser,2,361,149,93,38,55,56,18,48,39,9,1
16-01-2023,PrimeSeven,3,452,390,242,218,24,54,17,13,3,10,0
16-01-2023,PrimeSeven,1,615,46,23,2,21,84,74,70,67,3,2
16-01-2023,Aurora,3,976,372,467,13,454,50,17,40,18,22,3
16-01-2023,Mustangs,2,563,149,212,7,205,59,47,19,13,6,0
16-01-2023,Quicksilver,2,930,339,410,144,266,68,37,40,16,24,4
16-02-2021,GrayPanthers,2,885,572,138,5,133,92,14,43,23,20,4
16-02-2021,GrayPanthers,2,359,19,44,30,14,76,32,66,6,60,3
16-02-2021,Quicksilver,3,246,80,26,4,22,89,31,62,52,10,0
16-02-2021,Mustangs,1,746,554,262,110,152,77,0,43,24,19,3
16-02-2021,Aurora,1,734,270,212,152,60,89,74,77,63,14,6
16-02-2021,Discovery,2,454,381,252,179,73,81,21,9,6,3,0
16-02-2021,CelestialInterface,2,216,25,8,3,5,83,10,31,2,29,3
16-02-2021,BitterLaser,1,768,379,39,11,28,71,25,19,10,9,1
16-02-2021,Discovery,1,216,143,46,11,35,54,8,17,0,17,1
16-02-2021,ImpactTraining,1,567,163,537,457,80,71,41,45,34,11,5
16-02-2021,Discovery,1,718,404,434,100,334,79,26,17,11,6,0
16-02-2021,Discovery,3,861,155,852,219,633,65,2,12,4,8,0
16-02-2021,ImpactTraining,1,851,467,386,163,223,52,38,10,6,4,0
16-02-2021,Quicksilver,1,829,498,395,252,143,57,40,45,1,44,5
16-02-2022,Honeycomb,2,751,148,396,128,268,87,66,18,11,7,1
16-02-2022,Aurora,1,522,134,328,44,284,69,46,2,0,2,0
16-02-2022,Quicksilver,3,426,388,119,46,73,86,39,19,0,19,1
16-02-2022,Discovery,1,528,231,514,33,481,86,75,48,44,4,2
16-02-2022,Discovery,3,574,218,521,223,298,75,56,11,6,5,0
16-02-2022,Mustangs,1,808,186,141,116,25,63,48,18,3,15,1
16-02-2022,Honeycomb,2,658,592,572,184,388,86,82,19,3,16,0
16-02-2022,CelestialInterface,2,224,70,109,24,85,90,51,4,2,2,0
16-02-2022,Aurora,1,857,757,369,246,123,64,40,43,6,37,0
16-02-2022,Discovery,3,105,18,64,47,17,51,34,39,34,5,0
16-02-2022,CelestialInterface,2,258,38,119,30,89,74,18,46,13,33,3
16-02-2023,CelestialInterface,3,735,165,86,5,81,95,29,59,7,52,6
16-02-2023,BitterLaser,2,571,397,453,247,206,62,14,60,38,22,2
16-02-2023,Discovery,1,899,709,508,386,122,83,17,8,1,7,0
16-02-2023,Quicksilver,2,508,396,370,66,304,57,21,0,0,0,0
16-02-2023,GrayPanthers,1,495,81,258,227,31,100,38,39,9,30,1
16-02-2023,CelestialInterface,3,450,438,330,188,142,61,50,45,40,5,0
16-02-2023,GrayPanthers,2,272,83,235,40,195,63,37,52,34,18,6
16-02-2023,Honeycomb,3,771,410,375,154,221,78,9,55,4,51,0
16-02-2023,ImpactTraining,1,419,2,30,2,28,71,53,66,17,49,2
16-02-2023,PrimeSeven,3,162,59,108,14,94,53,30,38,36,2,3
16-02-2023,Discovery,2,873,159,409,224,185,79,28,4,2,2,0
16-02-2023,Discovery,3,404,252,329,79,250,81,11,76,21,55,2
16-02-2023,Mustangs,2,337,213,139,15,124,67,47,65,31,34,4
16-03-2021,ImpactTraining,2,776,592,335,298,37,79,16,30,6,24,2
16-03-2021,ImpactTraining,1,229,139,19,10,9,94,27,29,28,1,3
16-03-2021,GrayPanthers,3,104,44,68,57,11,100,61,35,6,29,0
16-03-2021,CelestialInterface,1,489,204,343,77,266,93,65,29,23,6,3
16-03-2021,BitterLaser,1,756,656,472,0,472,75,10,51,28,23,6
16-03-2021,Honeycomb,3,474,469,410,226,184,72,9,43,28,15,3
16-03-2021,Aurora,3,592,71,188,84,104,77,44,70,41,29,1
16-03-2021,Mustangs,3,464,155,249,7,242,81,59,26,19,7,2
16-03-2022,CelestialInterface,3,298,87,212,139,73,91,84,1,0,1,0
16-03-2022,CelestialInterface,3,929,218,308,110,198,57,46,50,13,37,1
16-03-2022,GrayPanthers,3,350,173,102,30,72,69,58,50,17,33,2
16-03-2022,Mustangs,3,581,62,197,100,97,93,23,29,9,20,3
16-03-2022,GrayPanthers,2,443,400,57,5,52,73,39,6,5,1,0
16-03-2022,Aurora,2,658,509,17,14,3,66,9,12,6,6,0
16-03-2022,Aurora,3,554,204,297,209,88,52,17,30,4,26,3
16-03-2022,GrayPanthers,3,496,210,327,259,68,97,49,9,0,9,0
16-03-2023,ImpactTraining,3,220,183,78,66,12,82,1,77,70,7,0
16-03-2023,Aurora,3,281,83,55,9,46,75,28,35,8,27,3
16-03-2023,CelestialInterface,1,227,7,16,13,3,95,64,91,82,9,3
16-03-2023,Discovery,1,322,181,195,104,91,75,43,62,5,57,2
16-03-2023,GrayPanthers,3,893,389,851,87,764,72,8,29,2,27,1
16-03-2023,Honeycomb,2,771,86,484,77,407,86,10,53,14,39,4
16-04-2021,BitterLaser,1,645,616,570,498,72,70,66,2,0,2,0
16-04-2021,BitterLaser,3,333,71,194,127,67,91,42,23,0,23,2
16-04-2021,GrayPanthers,2,733,688,439,216,223,61,22,14,3,11,0
16-04-2021,ImpactTraining,3,311,177,283,239,44,66,35,20,10,10,1
16-04-2022,Discovery,1,511,253,266,117,149,89,76,8,6,2,0
16-04-2022,Quicksilver,2,605,323,183,134,49,80,47,71,2,69,2
16-04-2022,PrimeSeven,2,786,448,227,129,98,96,26,34,7,27,1
16-04-2022,Quicksilver,1,183,170,155,84,71,94,22,53,47,6,6
16-04-2022,Honeycomb,1,774,538,224,81,143,88,54,41,34,7,4
16-04-2022,ImpactTraining,1,748,497,624,473,151,83,75,74,53,21,6
16-04-2022,BitterLaser,1,518,468,41,31,10,81,4,17,11,6,1
16-04-2022,GrayPanthers,1,547,312,510,405,105,91,3,13,2,11,0
16-04-2023,Aurora,1,910,401,507,92,415,82,10,32,24,8,3
16-04-2023,BitterLaser,1,411,249,345,304,41,92,77,33,29,4,1
16-04-2023,GrayPanthers,1,688,549,15,13,2,91,56,62,48,14,5
16-04-2023,Discovery,2,126,106,63,17,46,56,27,47,13,34,6
16-04-2023,Quicksilver,1,628,335,332,109,223,99,58,15,13,2,1
16-04-2023,Quicksilver,2,490,311,185,68,117,96,88,21,8,13,2
16-04-2023,GrayPanthers,2,631,584,286,135,151,59,13,4,2,2,0
16-04-2023,CelestialInterface,2,801,374,793,729,64,62,49,9,6,3,0
16-05-2021,GrayPanthers,3,165,80,80,49,31,95,62,66,36,30,8
16-05-2021,ImpactTraining,3,180,132,73,64,9,61,34,16,3,13,1
16-05-2021,Mustangs,1,371,303,241,168,73,78,70,57,14,43,6
16-05-2021,Mustangs,3,832,546,488,305,183,54,35,15,8,7,1
16-05-2021,ImpactTraining,1,733,96,591,152,439,71,15,9,8,1,0
16-05-2021,BitterLaser,1,217,176,202,164,38,83,11,41,5,36,0
16-05-2021,ImpactTraining,1,483,219,302,25,277,84,67,58,30,28,1
16-05-2021,ImpactTraining,1,127,41,108,9,99,87,32,6,3,3,0
16-05-2021,Mustangs,3,228,19,96,55,41,87,29,78,23,55,4
16-05-2021,Honeycomb,3,565,556,219,91,128,65,45,0,0,0,0
16-05-2021,Mustangs,1,206,110,57,16,41,82,39,4,3,1,0
16-05-2021,PrimeSeven,1,582,61,476,115,361,85,46,1,0,1,0
16-05-2022,CelestialInterface,2,995,508,44,29,15,66,59,32,16,16,1
16-05-2022,Quicksilver,2,320,138,228,89,139,62,24,8,2,6,0
16-05-2022,Aurora,1,250,92,4,1,3,66,30,35,22,13,1
16-05-2022,PrimeSeven,1,299,277,64,20,44,63,25,10,1,9,0
16-05-2022,Aurora,1,938,931,481,33,448,90,15,0,0,0,0
16-05-2022,Discovery,2,837,208,583,286,297,69,19,58,35,23,1
16-05-2022,Quicksilver,3,282,101,106,12,94,87,43,62,50,12,7
16-05-2022,GrayPanthers,3,548,374,78,45,33,77,37,0,0,0,0
16-05-2022,GrayPanthers,3,873,221,829,384,445,81,24,8,6,2,0
16-05-2022,Discovery,2,943,796,163,106,57,97,34,50,18,32,4
16-05-2023,Aurora,1,784,1,184,50,134,93,12,51,33,18,5
16-05-2023,BitterLaser,3,347,338,212,77,135,86,16,48,9,39,5
16-05-2023,GrayPanthers,1,448,207,437,124,313,87,17,75,70,5,10
16-05-2023,CelestialInterface,2,492,362,293,117,176,70,6,31,3,28,1
16-05-2023,CelestialInterface,1,951,781,881,246,635,90,71,66,50,16,4
16-05-2023,GrayPanthers,1,770,382,764,718,46,76,35,8,1,7,0
16-05-2023,Quicksilver,3,965,435,795,285,510,90,28,56,7,49,4
16-05-2023,GrayPanthers,1,692,583,177,95,82,97,25,45,14,31,1
16-05-2023,PrimeSeven,1,249,210,41,9,32,81,3,47,19,28,2
16-05-2023,Mustangs,1,505,74,187,32,155,76,55,8,5,3,0
16-05-2023,GrayPanthers,3,206,119,151,14,137,71,47,70,53,17,6
16-05-2023,BitterLaser,2,328,120,246,58,188,69,19,62,28,34,4
16-05-2023,PrimeSeven,2,180,168,67,35,32,96,79,59,51,8,7
16-05-2023,Discovery,1,964,876,546,513,33,59,43,19,15,4,1
16-06-2021,GrayPanthers,1,782,187,504,7,497,58,2,41,23,18,0
16-06-2021,BitterLaser,2,340,339,228,44,184,77,57,64,62,2,0
16-06-2021,Honeycomb,3,939,154,249,244,5,59,37,42,37,5,2
16-06-2021,Discovery,1,534,467,151,77,74,63,41,56,19,37,7
16-06-2021,Aurora,2,115,71,60,25,35,84,52,15,12,3,1
16-06-2021,Mustangs,1,773,299,35,13,22,58,38,45,6,39,1
16-06-2022,GrayPanthers,2,327,271,108,43,65,100,43,59,11,48,3
16-06-2022,GrayPanthers,1,367,162,192,13,179,60,49,27,3,24,1
16-06-2022,CelestialInterface,2,957,295,460,369,91,72,64,5,1,4,0
16-06-2022,Mustangs,3,242,75,128,39,89,92,7,87,32,55,6
16-06-2022,PrimeSeven,1,698,574,2,0,2,70,26,49,44,5,4
16-06-2022,GrayPanthers,1,596,256,591,522,69,96,34,72,65,7,2
16-06-2022,ImpactTraining,2,482,473,442,260,182,77,13,67,36,31,0
16-06-2022,BitterLaser,1,765,58,364,83,281,92,27,5,3,2,0
16-06-2022,Discovery,2,755,717,606,153,453,84,12,47,11,36,3
16-06-2023,CelestialInterface,3,531,156,113,77,36,62,20,49,15,34,6
16-06-2023,Honeycomb,3,708,117,346,13,333,90,73,80,3,77,3
16-06-2023,Mustangs,1,492,244,475,273,202,73,58,25,21,4,2
16-06-2023,ImpactTraining,2,356,180,349,281,68,77,50,25,14,11,0
16-06-2023,Quicksilver,3,298,199,210,182,28,77,14,26,25,1,0
16-06-2023,PrimeSeven,3,618,554,143,32,111,53,7,25,14,11,0
16-07-2021,Mustangs,3,561,447,186,153,33,59,18,32,27,5,3
16-07-2021,ImpactTraining,2,408,348,28,27,1,65,6,24,20,4,0
16-07-2021,PrimeSeven,3,215,8,204,48,156,61,15,58,25,33,2
16-07-2021,Mustangs,1,468,374,113,91,22,90,31,70,3,67,7
16-07-2021,Honeycomb,3,742,737,54,13,41,76,74,26,1,25,1
16-07-2021,CelestialInterface,2,354,196,15,13,2,99,68,9,8,1,0
16-07-2022,Aurora,1,240,161,231,220,11,74,28,47,12,35,3
16-07-2022,Aurora,2,766,375,439,352,87,96,48,21,8,13,0
16-07-2022,CelestialInterface,3,692,128,195,133,62,83,28,12,9,3,0
16-07-2022,GrayPanthers,1,128,4,95,62,33,89,12,37,10,27,2
16-07-2022,Aurora,1,503,285,53,26,27,96,47,24,10,14,2
16-07-2022,PrimeSeven,3,420,344,392,98,294,92,46,71,46,25,7
16-07-2023,ImpactTraining,3,458,26,248,163,85,72,21,15,7,8,0
16-07-2023,BitterLaser,2,192,100,33,0,33,50,9,30,5,25,0
16-07-2023,PrimeSeven,2,838,324,682,35,647,72,14,39,38,1,0
16-07-2023,CelestialInterface,2,470,293,35,24,11,94,8,85,5,80,1
16-07-2023,BitterLaser,1,688,146,97,0,97,76,65,29,20,9,3
16-07-2023,BitterLaser,1,871,763,145,115,30,52,12,26,23,3,1
16-07-2023,Quicksilver,1,259,61,32,9,23,99,7,54,36,18,6
16-08-2021,CelestialInterface,2,428,276,204,148,56,90,17,63,9,54,0
16-08-2021,Discovery,2,705,403,500,458,42,61,30,23,15,8,1
16-08-2021,CelestialInterface,2,955,459,80,18,62,92,9,8,5,3,0
16-08-2021,BitterLaser,3,970,277,85,42,43,53,38,10,3,7,0
16-08-2021,Mustangs,1,352,102,351,116,235,99,32,14,11,3,0
16-08-2021,ImpactTraining,3,446,350,4,3,1,53,0,46,2,44,2
16-08-2022,Quicksilver,2,909,279,642,474,168,67,8,51,20,31,3
16-08-2022,BitterLaser,1,516,375,2,0,2,81,33,55,33,22,1
16-08-2022,Mustangs,2,483,20,140,2,138,58,17,22,2,20,0
16-08-2022,Discovery,2,106,79,96,61,35,58,32,19,14,5,1
16-08-2022,GrayPanthers,3,945,517,103,55,48,98,76,76,52,24,8
16-08-2022,ImpactTraining,1,494,5,8,2,6,82,23,77,59,18,2
16-08-2022,Aurora,1,355,209,21,1,20,65,33,7,4,3,0
16-08-2022,ImpactTraining,2,438,26,197,68,129,66,42,55,6,49,1
16-08-2023,Aurora,3,854,786,336,234,102,52,22,33,1,32,3
16-08-2023,CelestialInterface,1,594,478,58,33,25,87,78,82,23,59,8
16-08-2023,GrayPanthers,3,407,396,303,163,140,60,17,31,0,31,0
16-08-2023,CelestialInterface,1,141,51,12,11,1,92,3,8,7,1,0
16-08-2023,Quicksilver,1,722,66,631,455,176,100,77,44,21,23,4
16-08-2023,BitterLaser,2,892,763,206,149,57,83,37,48,4,44,5
16-08-2023,Aurora,1,892,563,517,149,368,84,49,62,60,2,4
16-08-2023,Quicksilver,1,204,107,110,83,27,52,47,8,2,6,0
16-08-2023,BitterLaser,1,623,42,389,288,101,64,17,48,8,40,4
16-08-2023,CelestialInterface,1,319,80,316,81,235,76,38,73,36,37,1
16-08-2023,PrimeSeven,3,515,465,129,13,116,59,12,17,13,4,1
16-08-2023,Quicksilver,3,138,130,62,7,55,82,21,49,12,37,6
16-09-2021,Quicksilver,1,306,246,50,34,16,89,31,74,14,60,2
16-09-2021,BitterLaser,3,508,49,154,55,99,100,13,36,35,1,3
16-09-2021,BitterLaser,1,231,194,61,38,23,76,53,1,0,1,0
16-09-2021,Discovery,3,447,257,118,82,36,79,47,20,0,20,1
16-09-2021,GrayPanthers,1,729,257,511,266,245,69,8,36,6,30,3
16-09-2021,Discovery,3,471,366,48,36,12,97,68,89,3,86,5
16-09-2022,Quicksilver,2,809,604,27,15,12,87,60,82,59,23,5
16-09-2022,ImpactTraining,2,636,191,396,228,168,78,15,67,60,7,3
16-09-2022,Honeycomb,2,100,0,57,38,19,77,41,9,6,3,0
16-09-2022,ImpactTraining,3,301,0,115,64,51,90,49,27,4,23,3
16-09-2022,PrimeSeven,1,641,623,302,23,279,91,8,3,2,1,0
16-09-2022,Honeycomb,3,565,405,264,194,70,73,39,58,25,33,5
16-09-2022,Aurora,3,679,526,519,0,519,85,51,13,6,7,0
16-09-2022,PrimeSeven,3,362,207,301,103,198,91,50,8,3,5,0
16-09-2023,ImpactTraining,1,759,333,413,214,199,68,34,59,23,36,6
16-09-2023,Aurora,3,754,322,212,106,106,51,12,20,10,10,2
16-09-2023,Aurora,1,386,127,68,10,58,89,0,49,24,25,2
16-09-2023,Honeycomb,1,354,319,293,279,14,51,31,39,14,25,2
16-09-2023,BitterLaser,1,700,292,542,541,1,86,17,52,3,49,0
16-09-2023,GrayPanthers,2,158,44,27,2,25,93,53,58,34,24,4
16-09-2023,PrimeSeven,1,341,260,317,98,219,80,31,29,12,17,0
16-09-2023,Honeycomb,2,110,47,60,56,4,87,44,21,2,19,0
16-09-2023,Mustangs,3,972,309,316,169,147,60,33,5,3,2,0
16-09-2023,BitterLaser,2,147,145,125,97,28,93,53,5,2,3,0
16-09-2023,Aurora,1,743,157,684,608,76,66,49,64,55,9,4
16-09-2023,Mustangs,2,897,806,312,138,174,64,49,36,35,1,0
16-09-2023,BitterLaser,1,855,514,635,260,375,57,6,19,14,5,1
16-10-2021,Aurora,3,120,42,43,3,40,76,75,10,9,1,0
16-10-2021,Honeycomb,3,591,63,62,54,8,91,46,77,8,69,7
16-10-2021,Quicksilver,2,786,11,301,282,19,96,75,65,1,64,5
16-10-2021,Mustangs,1,163,94,20,12,8,84,57,22,6,16,2
16-10-2021,Honeycomb,2,289,93,21,11,10,50,13,5,3,2,0
16-10-2021,Quicksilver,2,769,427,547,48,499,61,43,14,13,1,0
16-10-2021,Discovery,1,980,813,134,3,131,93,51,19,15,4,0
16-10-2021,Aurora,1,540,403,22,20,2,66,32,28,19,9,1
16-10-2021,GrayPanthers,1,397,61,171,62,109,90,24,44,18,26,5
16-10-2021,GrayPanthers,3,207,30,156,73,83,89,7,20,9,11,1
16-10-2022,PrimeSeven,2,532,183,237,140,97,79,45,14,2,12,0
16-10-2022,Honeycomb,3,689,16,256,194,62,66,55,55,27,28,5
16-10-2022,Honeycomb,3,533,391,354,293,61,75,70,33,0,33,2
16-10-2022,Quicksilver,1,403,258,293,140,153,70,63,54,39,15,4
16-10-2022,GrayPanthers,3,480,262,184,81,103,72,69,58,18,40,5
16-10-2022,Discovery,3,322,23,278,8,270,87,75,65,56,9,8
16-10-2022,CelestialInterface,3,689,460,246,216,30,70,54,12,10,2,0
16-10-2022,PrimeSeven,3,311,280,90,46,44,72,63,20,5,15,2
16-10-2022,Mustangs,2,421,84,217,58,159,71,61,49,27,22,1
16-10-2022,CelestialInterface,2,557,195,360,32,328,91,43,85,8,77,8
16-10-2022,ImpactTraining,2,476,326,34,20,14,72,24,39,2,37,3
16-10-2023,Mustangs,1,456,277,455,328,127,72,13,51,21,30,0
16-10-2023,Discovery,2,146,35,14,8,6,80,59,54,16,38,4
16-10-2023,Discovery,3,760,686,31,27,4,100,65,30,13,17,3
16-10-2023,PrimeSeven,2,635,506,219,177,42,86,37,4,1,3,0
16-10-2023,Mustangs,3,654,344,165,41,124,79,15,37,14,23,0
16-10-2023,ImpactTraining,3,977,676,755,544,211,73,17,46,40,6,3
16-10-2023,Discovery,2,981,665,334,286,48,54,18,47,27,20,1
16-10-2023,BitterLaser,1,1000,915,352,94,258,99,79,26,25,1,2
16-10-2023,Quicksilver,1,513,177,209,50,159,100,99,16,3,13,0
16-10-2023,GrayPanthers,2,122,61,33,14,19,56,23,20,3,17,2
16-11-2021,Mustangs,1,728,497,445,119,326,88,27,86,79,7,9
16-11-2021,ImpactTraining,2,502,32,394,63,331,87,74,26,17,9,0
16-11-2021,CelestialInterface,2,312,292,64,14,50,55,9,7,0,7,0
16-11-2021,Quicksilver,1,629,139,236,121,115,63,27,49,23,26,1
16-11-2021,ImpactTraining,2,902,817,849,307,542,96,0,44,9,35,0
16-11-2021,Discovery,3,747,289,30,16,14,76,30,24,14,10,0
16-11-2021,Honeycomb,1,765,645,672,613,59,70,49,23,8,15,0
16-11-2021,ImpactTraining,1,753,570,156,97,59,59,5,41,23,18,3
16-11-2021,ImpactTraining,1,303,90,203,132,71,62,59,38,0,38,0
16-11-2021,Honeycomb,3,470,43,131,63,68,71,15,13,4,9,0
16-11-2021,Discovery,1,108,79,7,1,6,78,55,4,3,1,0
16-11-2021,Aurora,2,684,204,486,333,153,88,23,18,16,2,0
16-11-2021,ImpactTraining,2,516,113,53,17,36,94,51,37,12,25,3
16-11-2021,Honeycomb,2,936,110,906,6,900,53,37,19,12,7,1
16-11-2021,Aurora,2,844,547,477,242,235,97,39,82,7,75,5
16-11-2021,Discovery,2,768,732,361,299,62,73,50,5,4,1,0
16-11-2022,Quicksilver,3,874,43,450,154,296,60,19,55,1,54,4
16-11-2022,Aurora,3,599,76,412,36,376,74,3,14,3,11,1
16-11-2022,Aurora,3,272,149,116,86,30,87,41,28,5,23,0
16-11-2022,PrimeSeven,2,772,420,9,1,8,65,31,11,8,3,0
16-11-2022,Aurora,3,243,35,114,31,83,90,56,58,23,35,4
16-11-2022,CelestialInterface,1,630,157,193,100,93,55,52,33,2,31,1
16-11-2022,Aurora,2,522,508,393,254,139,60,30,42,21,21,2
16-11-2022,Mustangs,2,662,59,339,109,230,66,54,31,21,10,3
16-11-2022,Quicksilver,2,349,72,102,80,22,90,37,84,48,36,11
16-11-2022,Aurora,2,420,154,319,217,102,73,20,29,0,29,0
16-11-2022,Discovery,2,786,678,286,220,66,79,9,43,22,21,5
16-11-2022,Honeycomb,1,105,64,24,6,18,87,6,12,7,5,0
16-11-2023,GrayPanthers,2,290,288,220,115,105,51,38,35,17,18,4
16-11-2023,Honeycomb,2,175,140,43,35,8,83,71,3,2,1,0
16-11-2023,Aurora,1,893,154,570,351,219,77,34,71,34,37,1
16-11-2023,BitterLaser,3,620,197,201,78,123,77,35,59,53,6,2
16-11-2023,Discovery,2,124,82,46,40,6,59,57,26,22,4,2
16-11-2023,CelestialInterface,2,626,364,223,150,73,60,35,57,50,7,2
16-11-2023,BitterLaser,2,189,159,134,74,60,74,28,50,45,5,0
16-11-2023,Discovery,2,732,347,8,2,6,76,29,32,21,11,0
16-11-2023,GrayPanthers,1,765,269,516,230,286,84,6,32,29,3,0
16-11-2023,Quicksilver,2,170,79,86,13,73,94,10,48,26,22,3
16-11-2023,Quicksilver,2,754,255,183,76,107,79,9,57,39,18,6
16-11-2023,PrimeSeven,3,366,336,159,64,95,74,72,12,10,2,0
16-11-2023,Mustangs,1,579,67,113,110,3,74,37,59,0,59,7
16-11-2023,Quicksilver,3,132,13,36,24,12,67,48,42,23,19,1
16-11-2023,Honeycomb,3,165,164,40,21,19,73,48,16,13,3,1
16-11-2023,Quicksilver,1,599,477,450,38,412,96,88,11,2,9,0
16-12-2021,GrayPanthers,1,981,389,565,501,64,62,44,29,5,24,0
16-12-2021,Discovery,1,454,128,159,140,19,91,18,90,8,82,8
16-12-2021,PrimeSeven,1,753,743,364,19,345,88,12,84,35,49,0
16-12-2021,GrayPanthers,2,677,3,289,253,36,70,0,49,28,21,6
16-12-2021,Quicksilver,1,665,406,302,248,54,62,28,61,53,8,5
16-12-2021,CelestialInterface,3,802,599,236,222,14,60,1,45,29,16,2
16-12-2022,Discovery,3,262,37,225,31,194,52,34,11,1,10,0
16-12-2022,Aurora,2,709,4,1,0,1,73,67,26,12,14,0
16-12-2022,Mustangs,3,495,452,199,139,60,52,27,37,6,31,2
16-12-2022,BitterLaser,3,573,467,206,15,191,91,25,72,28,44,0
16-12-2022,PrimeSeven,2,299,178,79,19,60,86,60,81,80,1,4
16-12-2022,BitterLaser,2,177,129,71,61,10,63,23,26,12,14,1
16-12-2022,Honeycomb,1,208,43,79,41,38,60,30,18,13,5,0
16-12-2022,PrimeSeven,3,607,197,449,77,372,77,6,58,13,45,1
16-12-2022,Mustangs,3,601,242,85,19,66,75,69,17,4,13,1
16-12-2022,GrayPanthers,1,819,356,384,53,331,96,88,41,1,40,2
16-12-2022,Honeycomb,1,156,52,142,65,77,90,69,19,9,10,1
16-12-2022,Aurora,2,718,37,651,298,353,67,26,60,15,45,6
16-12-2022,CelestialInterface,1,754,113,94,73,21,75,29,26,21,5,1
16-12-2022,CelestialInterface,3,744,664,625,132,493,55,28,48,38,10,6
16-12-2023,PrimeSeven,1,647,128,260,153,107,99,89,75,50,25,2
16-12-2023,Quicksilver,3,825,379,138,116,22,79,54,59,28,31,2
16-12-2023,PrimeSeven,3,440,434,25,1,24,50,47,36,13,23,0
16-12-2023,Mustangs,1,910,356,28,16,12,66,24,55,35,20,5
16-12-2023,GrayPanthers,3,931,604,578,140,438,89,61,39,32,7,1
16-12-2023,Mustangs,2,426,4,360,208,152,85,62,45,39,6,3
16-12-2023,Quicksilver,2,707,395,9,1,8,52,6,40,39,1,3
16-12-2023,ImpactTraining,2,185,2,97,6,91,55,17,24,17,7,2
16-12-2023,Quicksilver,1,604,419,252,214,38,70,67,19,0,19,1
16-12-2023,ImpactTraining,1,299,40,286,238,48,93,9,86,31,55,5
17-01-2021,Discovery,3,275,179,127,5,122,79,47,8,7,1,0
17-01-2021,Mustangs,1,334,114,176,37,139,87,24,43,11,32,3
17-01-2021,Aurora,1,943,524,232,85,147,53,44,5,0,5,0
17-01-2021,Mustangs,2,365,195,227,49,178,91,87,48,47,1,1
17-01-2021,BitterLaser,1,108,72,10,7,3,79,50,32,7,25,2
17-01-2021,Quicksilver,1,355,9,322,28,294,91,64,73,51,22,1
17-01-2021,Aurora,3,573,101,218,169,49,65,6,11,7,4,0
17-01-2021,PrimeSeven,1,874,746,109,48,61,56,6,13,4,9,0
17-01-2022,Aurora,2,997,685,792,732,60,84,64,25,23,2,0
17-01-2022,GrayPanthers,2,463,455,24,14,10,87,46,70,23,47,4
17-01-2022,GrayPanthers,1,691,360,394,267,127,98,55,94,78,16,1
17-01-2022,Discovery,2,693,220,110,11,99,76,19,73,23,50,3
17-01-2022,ImpactTraining,3,180,102,159,31,128,50,7,34,5,29,2
17-01-2022,GrayPanthers,3,355,127,107,78,29,76,40,8,2,6,0
17-01-2023,GrayPanthers,3,186,61,160,21,139,62,8,26,7,19,0
17-01-2023,GrayPanthers,3,666,267,321,306,15,64,27,5,1,4,0
17-01-2023,Mustangs,3,609,37,322,28,294,59,17,34,23,11,4
17-01-2023,ImpactTraining,3,458,302,203,131,72,68,50,49,14,35,2
17-01-2023,CelestialInterface,3,470,336,325,168,157,62,46,19,14,5,0
17-01-2023,Mustangs,3,301,268,280,145,135,81,58,61,50,11,5
17-01-2023,Quicksilver,1,126,58,91,19,72,62,16,40,10,30,4
17-01-2023,ImpactTraining,1,348,257,339,153,186,98,3,2,1,1,0
17-01-2023,CelestialInterface,1,876,809,834,506,328,92,70,89,0,89,9
17-02-2021,PrimeSeven,1,337,320,0,0,0,70,10,68,23,45,2
17-02-2021,GrayPanthers,2,424,280,293,50,243,100,5,81,33,48,5
17-02-2021,CelestialInterface,3,883,337,871,542,329,87,11,35,16,19,4
17-02-2021,Discovery,3,822,577,243,183,60,82,31,17,12,5,1
17-02-2021,Honeycomb,1,760,283,59,7,52,52,15,19,16,3,0
17-02-2021,Quicksilver,3,784,558,660,39,621,98,10,82,34,48,10
17-02-2021,Honeycomb,2,774,118,157,59,98,99,49,7,3,4,0
17-02-2021,ImpactTraining,1,850,402,477,314,163,58,0,53,1,52,1
17-02-2022,Honeycomb,3,399,35,9,2,7,64,53,30,12,18,2
17-02-2022,PrimeSeven,3,675,83,248,92,156,64,61,2,0,2,0
17-02-2022,Aurora,3,716,176,644,140,504,79,78,8,5,3,0
17-02-2022,Aurora,3,434,295,29,22,7,71,30,29,15,14,3
17-02-2022,Mustangs,3,185,90,79,75,4,67,48,0,0,0,0
17-02-2022,ImpactTraining,1,431,301,97,95,2,73,34,43,5,38,5
17-02-2022,BitterLaser,3,996,311,4,2,2,76,60,21,2,19,0
17-02-2022,Honeycomb,1,887,293,738,160,578,59,47,40,8,32,3
17-02-2023,Discovery,1,699,363,436,354,82,56,54,9,1,8,0
17-02-2023,Mustangs,2,707,121,175,5,170,69,16,64,52,12,6
17-02-2023,GrayPanthers,2,921,287,562,192,370,71,16,28,20,8,0
17-02-2023,Aurora,3,174,82,31,15,16,79,62,29,9,20,0
17-02-2023,ImpactTraining,1,982,862,312,218,94,71,43,15,13,2,1
17-02-2023,BitterLaser,1,566,475,44,28,16,76,45,49,3,46,3
17-02-2023,CelestialInterface,3,641,430,558,23,535,55,52,43,30,13,1
17-02-2023,GrayPanthers,1,772,168,492,131,361,99,74,92,72,20,12
17-02-2023,ImpactTraining,3,843,23,196,1,195,62,50,34,14,20,3
17-02-2023,Quicksilver,2,343,267,238,181,57,57,35,54,37,17,1
17-02-2023,CelestialInterface,2,537,437,473,104,369,55,37,26,2,24,2
17-03-2021,Mustangs,1,366,349,151,63,88,88,3,53,19,34,1
17-03-2021,PrimeSeven,3,774,641,224,81,143,63,33,12,4,8,0
17-03-2021,BitterLaser,2,875,336,673,417,256,52,37,22,9,13,1
17-03-2021,PrimeSeven,2,479,289,367,135,232,93,51,32,14,18,2
17-03-2021,BitterLaser,1,738,152,651,49,602,84,75,68,16,52,9
17-03-2021,Aurora,3,741,198,345,167,178,68,57,66,22,44,6
17-03-2021,Honeycomb,2,339,192,130,83,47,64,48,3,2,1,0
17-03-2021,Mustangs,1,294,169,143,105,38,77,28,9,7,2,0
17-03-2021,PrimeSeven,3,586,362,540,346,194,97,1,55,49,6,0
17-03-2021,ImpactTraining,3,366,325,49,21,28,85,8,46,16,30,4
17-03-2021,Aurora,2,449,106,13,5,8,60,46,45,5,40,4
17-03-2021,ImpactTraining,1,108,86,59,12,47,94,82,15,4,11,1
17-03-2022,CelestialInterface,2,959,527,562,432,130,82,44,43,12,31,0
17-03-2022,Aurora,3,469,36,334,43,291,92,52,4,0,4,0
17-03-2022,Mustangs,2,739,380,340,163,177,87,0,56,15,41,0
17-03-2022,Honeycomb,3,141,55,91,52,39,100,85,21,1,20,1
17-03-2022,PrimeSeven,3,743,646,296,275,21,58,55,42,27,15,5
17-03-2022,GrayPanthers,3,636,48,61,54,7,66,60,62,30,32,7
17-03-2022,BitterLaser,1,123,81,1,0,1,55,15,5,1,4,0
17-03-2023,Discovery,1,446,294,92,3,89,55,0,7,1,6,0
17-03-2023,Honeycomb,3,273,51,219,174,45,92,23,61,13,48,4
17-03-2023,GrayPanthers,3,993,774,19,10,9,67,39,23,21,2,1
17-03-2023,PrimeSeven,2,626,280,47,15,32,80,6,0,0,0,0
17-03-2023,BitterLaser,2,241,222,203,142,61,87,19,72,67,5,7
17-03-2023,GrayPanthers,3,547,6,8,0,8,51,15,9,5,4,0
17-03-2023,GrayPanthers,3,249,90,77,73,4,98,63,88,78,10,1
17-04-2021,CelestialInterface,2,176,76,107,7,100,100,39,46,22,24,4
17-04-2021,PrimeSeven,3,425,272,353,174,179,58,49,54,4,50,4
17-04-2021,Honeycomb,2,988,481,944,341,603,60,0,27,22,5,2
17-04-2021,ImpactTraining,2,577,330,558,470,88,50,17,35,2,33,4
17-04-2021,ImpactTraining,3,369,359,230,139,91,79,77,15,3,12,1
17-04-2021,Quicksilver,1,157,105,66,59,7,69,65,32,13,19,2
17-04-2021,CelestialInterface,1,490,22,92,22,70,88,12,24,21,3,1
17-04-2021,Mustangs,1,134,86,71,21,50,79,73,60,50,10,7
17-04-2022,GrayPanthers,3,352,247,349,346,3,94,6,85,53,32,4
17-04-2022,GrayPanthers,2,117,103,76,42,34,96,74,11,5,6,0
17-04-2022,GrayPanthers,3,185,145,175,78,97,62,29,33,8,25,0
17-04-2022,Mustangs,3,722,360,715,57,658,85,34,52,43,9,4
17-04-2022,BitterLaser,2,375,328,337,158,179,83,7,19,4,15,1
17-04-2022,Aurora,2,269,222,21,2,19,67,56,56,1,55,7
17-04-2022,Mustangs,3,951,578,469,366,103,52,38,8,7,1,0
17-04-2022,CelestialInterface,2,451,276,278,202,76,73,49,45,2,43,5
17-04-2022,Discovery,1,780,276,719,139,580,91,81,15,7,8,0
17-04-2022,CelestialInterface,1,803,563,709,694,15,62,11,4,1,3,0
17-04-2022,Discovery,3,991,173,383,28,355,72,30,7,1,6,0
17-04-2022,Mustangs,2,663,385,208,86,122,77,10,12,3,9,0
17-04-2022,GrayPanthers,2,255,44,198,181,17,81,31,39,17,22,0
17-04-2023,Aurora,2,351,345,39,10,29,55,0,53,22,31,3
17-04-2023,Discovery,2,465,443,282,165,117,96,95,7,0,7,0
17-04-2023,Aurora,3,175,130,161,57,104,70,39,6,1,5,0
17-04-2023,PrimeSeven,3,632,330,331,195,136,55,31,27,19,8,3
17-05-2021,ImpactTraining,2,610,355,367,192,175,91,61,70,17,53,8
17-05-2021,Aurora,3,324,185,189,70,119,52,11,14,8,6,0
17-05-2021,BitterLaser,1,300,31,19,15,4,76,54,73,37,36,9
17-05-2021,Mustangs,1,491,455,410,140,270,82,62,25,2,23,1
17-05-2021,Quicksilver,2,816,630,786,330,456,80,62,17,11,6,1
17-05-2021,GrayPanthers,2,522,200,34,32,2,69,4,1,0,1,0
17-05-2021,BitterLaser,3,237,31,66,31,35,63,19,50,13,37,2
17-05-2021,Honeycomb,3,129,47,41,4,37,71,52,28,2,26,0
17-05-2021,CelestialInterface,3,775,653,477,440,37,86,45,83,44,39,4
17-05-2021,BitterLaser,2,403,223,164,40,124,88,29,72,48,24,9
17-05-2021,Mustangs,3,421,339,280,12,268,50,39,20,5,15,1
17-05-2021,Honeycomb,1,281,106,275,157,118,71,23,11,6,5,0
17-05-2021,PrimeSeven,3,547,218,506,108,398,50,23,46,30,16,5
17-05-2022,Mustangs,3,132,103,93,27,66,63,7,49,13,36,2
17-05-2022,Mustangs,3,413,175,57,36,21,83,82,17,15,2,0
17-05-2023,Aurora,3,533,426,199,63,136,82,58,12,11,1,0
17-05-2023,Honeycomb,2,276,161,32,4,28,64,22,1,0,1,0
17-05-2023,Quicksilver,3,186,122,156,71,85,74,18,42,32,10,5
17-05-2023,CelestialInterface,3,890,816,150,25,125,96,87,81,5,76,10
17-05-2023,Quicksilver,3,478,268,230,198,32,71,6,9,3,6,0
17-05-2023,GrayPanthers,2,629,412,368,96,272,74,14,60,42,18,0
17-05-2023,GrayPanthers,2,324,164,82,14,68,71,3,63,41,22,6
17-05-2023,PrimeSeven,2,256,110,132,42,90,64,41,54,6,48,6
17-05-2023,BitterLaser,3,958,520,602,431,171,93,61,32,8,24,1
17-06-2021,Discovery,2,651,482,103,80,23,82,78,55,25,30,1
17-06-2021,BitterLaser,1,235,30,133,47,86,84,57,68,24,44,0
17-06-2021,CelestialInterface,3,178,135,152,135,17,66,4,38,35,3,1
17-06-2021,Honeycomb,1,978,817,65,31,34,68,15,23,3,20,2
17-06-2021,Quicksilver,1,107,31,61,2,59,70,12,67,36,31,9
17-06-2021,Mustangs,3,609,217,277,187,90,93,26,54,12,42,4
17-06-2021,ImpactTraining,1,813,763,454,16,438,87,11,54,25,29,5
17-06-2021,CelestialInterface,2,580,469,121,67,54,56,25,29,19,10,0
17-06-2021,CelestialInterface,3,634,272,55,35,20,78,13,19,2,17,1
17-06-2021,Discovery,2,718,485,551,127,424,53,13,50,35,15,3
17-06-2021,GrayPanthers,3,472,208,431,389,42,79,72,28,15,13,0
17-06-2022,ImpactTraining,2,468,44,415,252,163,83,9,24,15,9,2
17-06-2022,PrimeSeven,2,884,79,373,336,37,82,37,23,6,17,2
17-06-2022,Quicksilver,1,855,76,526,296,230,100,9,98,67,31,10
17-06-2022,Quicksilver,3,633,233,218,168,50,77,34,71,50,21,4
17-06-2022,BitterLaser,1,941,865,509,115,394,100,94,82,52,30,10
17-06-2022,ImpactTraining,3,443,296,256,200,56,83,56,51,3,48,4
17-06-2022,PrimeSeven,1,152,133,143,78,65,60,18,59,21,38,4
17-06-2022,ImpactTraining,2,641,363,403,279,124,79,38,28,11,17,2
17-06-2022,BitterLaser,1,153,115,118,116,2,87,39,28,5,23,1
17-06-2022,PrimeSeven,2,879,59,179,82,97,67,50,15,11,4,0
17-06-2022,CelestialInterface,2,578,503,85,42,43,94,28,84,18,66,9
17-06-2022,ImpactTraining,3,705,296,286,2,284,51,33,3,1,2,0
17-06-2022,PrimeSeven,1,362,7,165,142,23,76,51,15,7,8,0
17-06-2022,PrimeSeven,2,774,168,545,59,486,51,41,25,17,8,0
17-06-2022,Aurora,3,484,430,200,66,134,74,23,46,43,3,1
17-06-2022,BitterLaser,2,575,567,458,335,123,57,12,14,3,11,1
17-06-2023,Aurora,1,571,209,521,32,489,92,26,65,53,12,6
17-06-2023,BitterLaser,2,579,502,185,34,151,71,58,63,4,59,1
17-06-2023,BitterLaser,3,269,166,118,97,21,77,67,6,1,5,0
17-06-2023,Quicksilver,2,534,249,435,242,193,54,2,29,10,19,3
17-06-2023,ImpactTraining,2,382,212,107,63,44,100,56,52,3,49,4
17-06-2023,Mustangs,3,241,148,84,49,35,64,21,17,7,10,1
17-06-2023,Quicksilver,3,241,162,212,40,172,73,48,15,7,8,0
17-06-2023,ImpactTraining,3,540,525,505,488,17,68,39,63,57,6,5
17-06-2023,ImpactTraining,3,687,554,244,145,99,98,52,15,4,11,0
17-06-2023,ImpactTraining,1,453,21,280,205,75,54,13,27,5,22,1
17-06-2023,Aurora,2,459,260,134,52,82,57,8,39,38,1,2
17-06-2023,PrimeSeven,3,490,204,423,331,92,75,10,51,47,4,4
17-07-2021,CelestialInterface,2,128,58,102,73,29,59,57,54,18,36,3
17-07-2021,CelestialInterface,2,785,610,233,135,98,56,22,42,27,15,2
17-07-2021,ImpactTraining,2,779,81,379,215,164,58,6,24,23,1,2
17-07-2021,Honeycomb,2,803,508,282,112,170,68,7,54,32,22,0
17-07-2021,Mustangs,1,507,339,69,43,26,96,74,1,0,1,0
17-07-2021,PrimeSeven,1,378,221,116,90,26,94,20,82,9,73,5
17-07-2021,ImpactTraining,2,806,57,315,36,279,93,40,37,10,27,4
17-07-2021,Mustangs,1,498,144,77,41,36,93,17,28,23,5,3
17-07-2021,Honeycomb,1,290,79,176,30,146,84,61,40,22,18,1
17-07-2022,CelestialInterface,1,551,497,219,4,215,80,12,5,4,1,0
17-07-2022,Quicksilver,2,380,322,103,82,21,72,19,2,0,2,0
17-07-2022,Mustangs,2,624,378,16,5,11,98,86,90,64,26,8
17-07-2022,PrimeSeven,3,588,336,520,242,278,94,87,61,15,46,0
17-07-2022,GrayPanthers,1,930,141,831,787,44,89,69,64,11,53,4
17-07-2022,Quicksilver,1,922,791,90,73,17,98,52,40,20,20,4
17-07-2022,Discovery,2,532,89,264,242,22,64,33,54,48,6,6
17-07-2022,Aurora,3,548,250,482,259,223,53,28,33,31,2,3
17-07-2022,Honeycomb,1,962,433,757,296,461,63,61,17,0,17,0
17-07-2022,Discovery,2,180,13,148,43,105,92,63,60,19,41,0
17-07-2022,Honeycomb,3,661,154,491,398,93,68,42,62,59,3,4
17-07-2022,Aurora,3,714,112,190,154,36,63,18,13,2,11,0
17-07-2022,GrayPanthers,2,438,123,243,31,212,81,18,8,4,4,0
17-07-2022,Discovery,1,507,161,340,75,265,82,55,4,3,1,0
17-07-2022,Aurora,1,104,0,31,27,4,66,15,24,20,4,1
17-07-2022,Mustangs,3,472,346,372,59,313,68,4,18,10,8,0
17-07-2023,PrimeSeven,3,835,232,828,683,145,59,52,51,35,16,4
17-07-2023,BitterLaser,3,573,37,41,12,29,81,40,5,0,5,0
17-07-2023,Honeycomb,2,717,60,319,253,66,58,22,18,16,2,0
17-07-2023,GrayPanthers,1,932,74,889,854,35,88,60,20,13,7,2
17-07-2023,ImpactTraining,3,461,236,251,16,235,89,64,28,14,14,3
17-08-2021,Aurora,2,643,504,193,12,181,66,1,41,28,13,2
17-08-2021,BitterLaser,3,850,589,419,191,228,52,13,44,21,23,5
17-08-2021,CelestialInterface,3,702,458,50,6,44,55,37,9,8,1,0
17-08-2021,GrayPanthers,3,863,399,439,275,164,87,23,29,6,23,3
17-08-2021,Aurora,3,223,141,152,47,105,77,8,35,20,15,4
17-08-2021,ImpactTraining,3,581,183,115,19,96,50,3,30,13,17,0
17-08-2021,Honeycomb,3,330,41,132,87,45,50,42,37,31,6,3
17-08-2021,Honeycomb,2,492,35,43,10,33,52,49,42,36,6,1
17-08-2021,CelestialInterface,3,273,191,112,59,53,97,74,26,20,6,2
17-08-2021,Discovery,1,722,400,705,490,215,64,47,63,44,19,7
17-08-2021,Quicksilver,2,144,53,98,75,23,80,6,27,20,7,1
17-08-2022,Honeycomb,2,322,292,311,11,300,85,48,26,2,24,2
17-08-2022,Aurora,2,198,147,4,2,2,77,59,42,14,28,3
17-08-2022,Aurora,3,942,182,304,244,60,53,49,50,32,18,2
17-08-2022,Quicksilver,2,724,349,56,43,13,54,31,24,7,17,0
17-08-2022,Aurora,1,937,393,401,188,213,81,72,70,8,62,8
17-08-2022,Quicksilver,3,363,122,209,48,161,72,45,14,5,9,1
17-08-2022,BitterLaser,2,399,395,362,2,360,55,20,46,21,25,4
17-08-2022,CelestialInterface,3,126,1,55,22,33,50,26,10,0,10,0
17-08-2022,Mustangs,3,429,229,428,78,350,94,48,66,34,32,1
17-08-2022,CelestialInterface,2,984,232,354,311,43,87,49,25,9,16,1
17-08-2023,Discovery,3,966,128,676,653,23,52,46,20,15,5,2
17-08-2023,Aurora,3,551,445,436,365,71,62,33,52,5,47,1
17-08-2023,Honeycomb,1,686,267,261,53,208,98,75,17,16,1,1
17-08-2023,Quicksilver,3,660,155,165,21,144,81,46,61,47,14,1
17-08-2023,GrayPanthers,3,380,11,135,68,67,100,53,57,53,4,5
17-08-2023,Discovery,2,198,139,105,60,45,80,38,32,17,15,0
17-08-2023,CelestialInterface,2,996,84,252,59,193,57,26,30,2,28,2
17-08-2023,CelestialInterface,2,525,68,406,241,165,82,17,26,24,2,0
17-08-2023,Honeycomb,3,690,171,400,263,137,52,39,39,33,6,0
17-08-2023,GrayPanthers,2,814,262,472,4,468,64,49,12,6,6,0
17-08-2023,Quicksilver,1,257,83,56,46,10,91,42,60,53,7,1
17-09-2021,GrayPanthers,3,499,428,436,233,203,72,41,59,3,56,3
17-09-2021,BitterLaser,3,981,718,910,160,750,77,73,40,28,12,3
17-09-2021,BitterLaser,2,430,172,373,219,154,76,47,43,6,37,1
17-09-2021,Aurora,2,362,349,165,126,39,70,47,64,38,26,3
17-09-2021,CelestialInterface,1,432,34,150,89,61,68,53,43,16,27,4
17-09-2021,BitterLaser,2,220,201,183,42,141,78,67,9,5,4,0
17-09-2022,ImpactTraining,3,107,97,44,8,36,78,75,53,38,15,6
17-09-2022,Discovery,1,984,731,507,33,474,74,30,53,46,7,5
17-09-2022,PrimeSeven,2,357,93,129,91,38,90,68,64,41,23,4
17-09-2022,ImpactTraining,3,932,21,775,69,706,100,19,7,6,1,0
17-09-2022,CelestialInterface,3,677,213,530,42,488,56,17,19,2,17,0
17-09-2023,Aurora,1,653,533,123,12,111,98,82,55,14,41,5
17-09-2023,GrayPanthers,3,138,67,90,57,33,98,1,50,3,47,6
17-09-2023,BitterLaser,1,408,332,131,39,92,66,7,33,12,21,0
17-09-2023,GrayPanthers,2,872,58,716,316,400,98,72,13,4,9,0
17-09-2023,CelestialInterface,2,467,360,284,55,229,62,59,21,10,11,1
17-09-2023,CelestialInterface,2,518,36,517,507,10,98,82,23,8,15,1
17-09-2023,Honeycomb,3,498,330,401,385,16,66,17,47,34,13,5
17-09-2023,PrimeSeven,3,106,85,8,4,4,90,41,8,3,5,0
17-09-2023,PrimeSeven,3,331,28,194,102,92,69,65,3,2,1,0
17-09-2023,Honeycomb,2,908,303,342,191,151,81,74,27,6,21,3
17-10-2021,Discovery,1,803,401,706,644,62,89,77,53,44,9,3
17-10-2021,PrimeSeven,1,623,85,473,270,203,99,37,97,3,94,6
17-10-2021,Mustangs,2,705,323,274,99,175,63,33,27,21,6,3
17-10-2021,PrimeSeven,1,924,857,90,66,24,72,13,51,12,39,0
17-10-2021,GrayPanthers,1,129,71,51,3,48,74,55,6,1,5,0
17-10-2021,Quicksilver,2,213,50,82,3,79,68,66,0,0,0,0
17-10-2021,Aurora,3,176,115,3,0,3,72,39,37,27,10,2
17-10-2021,GrayPanthers,3,686,367,445,145,300,77,6,41,35,6,0
17-10-2022,Aurora,1,705,313,480,195,285,95,22,23,0,23,2
17-10-2022,GrayPanthers,1,984,77,418,363,55,84,48,36,5,31,0
17-10-2022,BitterLaser,3,927,257,392,237,155,84,73,62,15,47,4
17-10-2022,Discovery,3,767,117,228,183,45,67,41,33,5,28,0
17-10-2022,BitterLaser,2,983,771,218,174,44,98,39,13,0,13,0
17-10-2022,CelestialInterface,2,693,500,101,45,56,90,25,16,11,5,1
17-10-2022,Quicksilver,2,464,383,104,13,91,76,61,34,9,25,0
17-10-2022,Honeycomb,3,313,34,186,6,180,71,41,2,1,1,0
17-10-2022,BitterLaser,2,473,56,121,78,43,79,74,56,42,14,1
17-10-2022,GrayPanthers,3,818,324,543,408,135,99,17,95,88,7,1
17-10-2023,GrayPanthers,1,599,176,244,108,136,60,47,24,18,6,0
17-10-2023,Aurora,2,640,13,265,122,143,67,23,33,0,33,3
17-10-2023,ImpactTraining,3,671,424,474,111,363,62,25,36,24,12,2
17-10-2023,PrimeSeven,2,313,279,284,176,108,84,19,24,12,12,2
17-10-2023,ImpactTraining,1,302,258,185,82,103,50,17,46,38,8,3
17-10-2023,ImpactTraining,3,602,562,15,10,5,71,26,16,1,15,0
17-10-2023,GrayPanthers,2,625,559,570,312,258,50,16,16,12,4,1
17-10-2023,Mustangs,3,888,410,478,452,26,68,59,31,19,12,2
17-11-2021,GrayPanthers,1,559,62,350,348,2,92,14,72,48,24,7
17-11-2021,ImpactTraining,2,753,703,515,143,372,54,11,34,13,21,4
17-11-2021,CelestialInterface,1,795,216,72,43,29,69,68,42,3,39,0
17-11-2021,Honeycomb,1,390,92,386,190,196,80,9,31,5,26,1
17-11-2021,Aurora,3,801,253,138,4,134,79,38,53,7,46,5
17-11-2021,Quicksilver,1,601,88,32,2,30,81,7,31,0,31,3
17-11-2021,Mustangs,3,397,51,146,81,65,97,33,13,6,7,0
17-11-2021,Quicksilver,2,513,160,10,6,4,95,16,82,67,15,5
17-11-2021,CelestialInterface,2,186,109,50,11,39,75,57,43,40,3,1
17-11-2022,Honeycomb,1,646,286,77,20,57,67,7,58,7,51,6
17-11-2022,PrimeSeven,3,271,260,139,37,102,70,20,43,16,27,0
17-11-2022,GrayPanthers,1,605,248,520,290,230,61,24,26,14,12,1
17-11-2022,CelestialInterface,1,517,141,478,386,92,52,17,22,20,2,0
17-11-2022,ImpactTraining,1,735,723,102,42,60,89,0,16,3,13,1
17-11-2022,CelestialInterface,2,856,396,458,357,101,59,52,15,11,4,0
17-11-2022,PrimeSeven,2,685,133,404,82,322,78,42,77,18,59,4
17-11-2022,GrayPanthers,3,326,183,319,140,179,94,33,11,4,7,0
17-11-2023,Mustangs,2,539,479,122,108,14,55,1,33,8,25,0
17-11-2023,Aurora,2,959,128,217,38,179,80,49,50,4,46,2
17-11-2023,PrimeSeven,2,772,670,238,5,233,95,23,61,36,25,0
17-11-2023,Honeycomb,3,538,464,267,218,49,63,1,2,0,2,0
17-11-2023,PrimeSeven,2,989,552,442,218,224,77,29,31,4,27,1
17-11-2023,Mustangs,1,148,104,145,142,3,75,63,41,30,11,4
17-11-2023,PrimeSeven,3,608,521,39,33,6,60,22,33,11,22,0
17-11-2023,Discovery,1,248,33,50,14,36,54,6,31,8,23,1
17-11-2023,Honeycomb,3,932,175,829,48,781,51,5,17,3,14,1
17-12-2021,Honeycomb,1,649,615,591,195,396,61,54,32,15,17,3
17-12-2021,Mustangs,1,457,3,225,97,128,64,24,50,24,26,3
17-12-2021,ImpactTraining,1,213,178,93,16,77,90,60,1,0,1,0
17-12-2021,CelestialInterface,1,157,55,120,79,41,62,31,21,17,4,2
17-12-2021,CelestialInterface,1,227,205,104,22,82,60,7,28,27,1,1
17-12-2021,Discovery,1,410,207,96,82,14,55,3,25,19,6,1
17-12-2021,GrayPanthers,1,977,795,446,265,181,63,33,50,6,44,4
17-12-2021,Discovery,2,977,548,333,114,219,78,0,31,12,19,0
17-12-2021,PrimeSeven,2,330,130,273,156,117,62,10,24,4,20,1
17-12-2022,CelestialInterface,2,714,693,99,78,21,54,17,30,8,22,2
17-12-2022,GrayPanthers,1,700,88,215,149,66,73,51,14,1,13,1
17-12-2022,PrimeSeven,3,127,52,50,6,44,61,39,29,15,14,0
17-12-2022,Discovery,2,185,160,26,24,2,96,79,67,33,34,0
17-12-2022,GrayPanthers,3,875,693,142,47,95,85,14,74,52,22,2
17-12-2022,Honeycomb,1,441,3,429,207,222,52,36,11,6,5,0
17-12-2022,BitterLaser,1,469,306,84,27,57,88,50,84,15,69,8
17-12-2022,ImpactTraining,1,846,832,776,528,248,71,14,70,1,69,8
17-12-2022,Discovery,1,697,587,476,257,219,60,36,13,8,5,0
17-12-2022,Discovery,2,279,0,206,128,78,56,27,25,1,24,0
17-12-2022,Quicksilver,2,294,265,81,23,58,99,69,72,0,72,3
17-12-2022,ImpactTraining,2,209,4,112,76,36,81,50,22,4,18,2
17-12-2022,Discovery,1,588,130,263,56,207,73,63,42,8,34,5
17-12-2023,Honeycomb,3,850,479,778,148,630,93,5,86,80,6,7
17-12-2023,PrimeSeven,3,350,324,331,155,176,54,35,13,1,12,0
17-12-2023,CelestialInterface,3,386,274,279,268,11,64,39,31,10,21,0
17-12-2023,CelestialInterface,1,483,252,57,13,44,68,37,4,1,3,0
17-12-2023,Discovery,2,902,501,279,223,56,94,76,45,6,39,2
17-12-2023,GrayPanthers,2,627,376,89,37,52,59,11,49,47,2,5
17-12-2023,GrayPanthers,3,930,896,277,272,5,79,73,45,21,24,1
17-12-2023,Honeycomb,3,206,64,106,55,51,90,57,4,1,3,0
17-12-2023,CelestialInterface,2,395,11,149,125,24,67,19,2,0,2,0
17-12-2023,Aurora,2,260,198,250,13,237,94,31,58,52,6,4
17-12-2023,PrimeSeven,3,379,69,276,41,235,67,25,57,47,10,7
17-12-2023,Honeycomb,1,812,587,388,160,228,91,67,56,51,5,1
17-12-2023,ImpactTraining,3,684,622,359,285,74,61,28,9,3,6,0
18-01-2021,Discovery,2,112,18,50,2,48,74,66,0,0,0,0
18-01-2021,Mustangs,3,354,205,97,17,80,71,47,47,45,2,3
18-01-2021,Mustangs,1,953,682,132,48,84,75,18,61,12,49,5
18-01-2021,Aurora,1,741,707,595,33,562,76,5,8,4,4,0
18-01-2021,ImpactTraining,1,105,56,55,15,40,51,30,18,6,12,0
18-01-2021,PrimeSeven,3,690,461,239,195,44,76,7,3,2,1,0
18-01-2021,Quicksilver,3,149,49,53,43,10,96,15,15,4,11,0
18-01-2021,Quicksilver,3,440,276,235,225,10,99,60,4,0,4,0
18-01-2021,GrayPanthers,2,625,119,526,191,335,75,17,54,26,28,0
18-01-2021,Aurora,1,703,194,219,205,14,51,25,31,26,5,0
18-01-2021,GrayPanthers,3,506,2,149,148,1,57,14,44,7,37,4
18-01-2022,BitterLaser,1,571,439,135,24,111,60,43,45,20,25,0
18-01-2022,Aurora,2,957,675,321,56,265,81,2,58,44,14,3
18-01-2022,Honeycomb,1,146,46,11,6,5,82,36,75,5,70,7
18-01-2022,Discovery,2,637,478,99,34,65,53,46,7,5,2,0
18-01-2022,CelestialInterface,3,935,182,93,39,54,65,25,30,22,8,3
18-01-2023,Honeycomb,2,718,493,413,30,383,98,87,67,1,66,2
18-01-2023,GrayPanthers,1,985,788,470,84,386,97,16,5,0,5,0
18-01-2023,Discovery,3,992,925,776,188,588,91,87,77,54,23,2
18-01-2023,Quicksilver,1,856,650,554,16,538,79,6,10,9,1,0
18-01-2023,GrayPanthers,3,107,80,85,26,59,92,21,52,46,6,3
18-01-2023,GrayPanthers,2,891,729,463,349,114,67,16,29,9,20,0
18-01-2023,Discovery,2,860,349,188,138,50,56,39,26,24,2,1
18-01-2023,BitterLaser,3,294,146,72,8,64,95,82,91,44,47,1
18-01-2023,GrayPanthers,1,998,454,645,582,63,83,75,7,2,5,0
18-01-2023,Quicksilver,1,108,32,69,68,1,59,55,17,16,1,0
18-01-2023,Honeycomb,2,317,315,117,26,91,64,22,54,32,22,4
18-01-2023,Mustangs,3,232,166,78,63,15,83,78,80,62,18,9
18-02-2021,ImpactTraining,1,437,160,71,47,24,52,50,33,0,33,2
18-02-2021,GrayPanthers,3,451,124,99,8,91,88,48,20,13,7,0
18-02-2021,Quicksilver,3,816,279,481,152,329,67,17,35,28,7,1
18-02-2021,ImpactTraining,1,329,171,121,96,25,87,31,76,66,10,3
18-02-2021,Aurora,2,107,25,17,3,14,62,18,19,14,5,1
18-02-2021,Mustangs,3,899,288,888,663,225,88,48,59,12,47,4
18-02-2021,GrayPanthers,1,156,64,35,2,33,89,1,37,33,4,3
18-02-2022,Discovery,2,528,145,103,11,92,58,21,16,14,2,0
18-02-2022,PrimeSeven,2,441,252,111,33,78,83,13,16,7,9,1
18-02-2022,Aurora,2,536,243,149,6,143,72,47,33,28,5,3
18-02-2022,Mustangs,1,630,308,414,99,315,69,38,5,3,2,0
18-02-2022,Honeycomb,1,756,599,89,19,70,88,52,12,10,2,0
18-02-2022,Discovery,1,128,53,5,4,1,67,16,57,41,16,3
18-02-2022,Aurora,1,763,595,562,326,236,83,26,37,6,31,2
18-02-2022,Mustangs,2,698,349,580,335,245,76,13,67,40,27,9
18-02-2022,ImpactTraining,1,201,78,169,60,109,82,58,13,10,3,0
18-02-2022,Honeycomb,2,688,647,647,227,420,63,28,60,17,43,4
18-02-2022,Aurora,3,502,458,51,46,5,70,45,8,5,3,0
18-02-2023,BitterLaser,3,920,11,320,313,7,88,59,4,3,1,0
18-02-2023,CelestialInterface,2,682,305,311,100,211,99,68,21,2,19,0
18-02-2023,BitterLaser,2,831,397,569,169,400,100,20,11,0,11,0
18-02-2023,Honeycomb,3,686,47,642,473,169,88,2,36,12,24,0
18-02-2023,Quicksilver,3,307,252,286,276,10,85,54,16,13,3,0
18-02-2023,Mustangs,2,249,187,11,9,2,91,64,62,36,26,3
18-02-2023,Honeycomb,2,669,584,131,61,70,94,76,33,22,11,3
18-03-2021,Mustangs,2,104,99,77,62,15,89,45,20,19,1,2
18-03-2021,ImpactTraining,2,382,142,5,0,5,71,46,47,40,7,3
18-03-2021,Discovery,1,836,398,84,64,20,85,76,83,53,30,8
18-03-2021,BitterLaser,1,483,187,377,141,236,93,83,65,58,7,8
18-03-2021,Honeycomb,3,430,231,219,131,88,60,40,46,36,10,4
18-03-2021,BitterLaser,1,480,429,469,395,74,87,69,20,8,12,1
18-03-2021,PrimeSeven,1,306,143,165,153,12,83,53,40,35,5,0
18-03-2021,Discovery,3,812,416,462,222,240,66,15,12,1,11,0
18-03-2021,ImpactTraining,3,384,185,42,36,6,61,31,57,43,14,1
18-03-2021,GrayPanthers,1,838,266,193,157,36,76,2,65,15,50,3
18-03-2021,CelestialInterface,2,635,349,505,176,329,100,57,6,3,3,0
18-03-2021,Quicksilver,2,791,66,784,333,451,93,57,70,44,26,0
18-03-2022,ImpactTraining,2,629,83,319,9,310,63,4,40,0,40,5
18-03-2022,Mustangs,2,411,151,268,76,192,89,9,27,26,1,3
18-03-2023,PrimeSeven,2,306,26,55,17,38,57,17,18,13,5,0
18-03-2023,Honeycomb,2,794,562,299,27,272,71,34,26,2,24,1
18-03-2023,GrayPanthers,1,831,465,21,17,4,62,7,21,11,10,1
18-03-2023,Honeycomb,2,679,438,383,368,15,91,56,15,1,14,1
18-03-2023,Mustangs,3,237,100,162,107,55,69,44,59,21,38,2
18-03-2023,CelestialInterface,2,914,83,252,203,49,60,29,54,50,4,1
18-03-2023,GrayPanthers,3,264,8,173,120,53,92,72,43,29,14,5
18-03-2023,ImpactTraining,1,567,566,175,57,118,62,31,21,11,10,0
18-04-2021,CelestialInterface,3,496,323,121,75,46,81,29,50,5,45,0
18-04-2021,Honeycomb,1,278,274,198,119,79,84,17,14,12,2,0
18-04-2021,PrimeSeven,2,319,121,206,76,130,62,14,2,1,1,0
18-04-2021,ImpactTraining,3,861,11,322,16,306,67,22,37,26,11,0
18-04-2021,GrayPanthers,3,847,602,344,334,10,71,29,66,25,41,6
18-04-2021,PrimeSeven,1,868,523,500,294,206,100,61,67,19,48,8
18-04-2021,Honeycomb,3,862,9,723,313,410,94,58,19,9,10,0
18-04-2021,PrimeSeven,1,315,42,38,2,36,94,24,14,12,2,0
18-04-2022,Honeycomb,2,448,35,154,99,55,67,56,39,20,19,4
18-04-2022,Aurora,2,655,2,554,382,172,54,36,26,25,1,2
18-04-2022,Discovery,2,878,521,609,226,383,99,74,30,19,11,2
18-04-2022,Honeycomb,2,162,60,10,5,5,83,56,63,32,31,5
18-04-2022,BitterLaser,3,440,6,400,174,226,56,32,20,3,17,2
18-04-2023,Discovery,3,659,585,27,26,1,81,3,65,9,56,7
18-04-2023,CelestialInterface,3,779,662,356,44,312,74,59,46,22,24,3
18-04-2023,BitterLaser,1,447,319,88,39,49,68,61,33,26,7,3
18-04-2023,ImpactTraining,2,774,365,694,384,310,95,15,82,25,57,2
18-04-2023,Discovery,1,801,5,404,108,296,53,52,21,17,4,1
18-04-2023,Discovery,3,315,48,135,5,130,75,12,24,1,23,1
18-04-2023,Mustangs,3,565,196,195,153,42,65,61,57,27,30,6
18-04-2023,ImpactTraining,3,754,488,88,18,70,63,9,38,3,35,4
18-04-2023,BitterLaser,2,417,86,380,164,216,71,52,1,0,1,0
18-05-2021,BitterLaser,2,376,305,246,235,11,66,60,26,21,5,1
18-05-2021,CelestialInterface,1,175,21,78,36,42,96,33,82,14,68,11
18-05-2021,Discovery,3,402,11,301,191,110,96,11,45,36,9,1
18-05-2021,Mustangs,1,712,220,614,267,347,63,25,14,9,5,0
18-05-2021,BitterLaser,1,376,166,109,37,72,72,21,38,5,33,2
18-05-2021,GrayPanthers,1,456,401,453,279,174,99,1,30,18,12,3
18-05-2021,CelestialInterface,3,993,984,604,603,1,88,35,9,3,6,0
18-05-2021,Quicksilver,1,919,677,163,139,24,68,18,35,29,6,2
18-05-2021,Aurora,3,436,404,110,96,14,97,14,83,56,27,2
18-05-2021,GrayPanthers,2,850,56,543,134,409,83,60,77,2,75,0
18-05-2022,GrayPanthers,2,597,29,189,163,26,64,16,56,40,16,5
18-05-2022,ImpactTraining,3,919,124,425,314,111,92,56,11,3,8,0
18-05-2022,Discovery,3,317,191,242,124,118,60,35,33,26,7,2
18-05-2022,BitterLaser,3,218,180,74,64,10,99,78,90,60,30,12
18-05-2022,PrimeSeven,1,182,74,106,92,14,79,23,62,37,25,6
18-05-2022,Mustangs,3,617,330,307,299,8,56,39,4,2,2,0
18-05-2022,ImpactTraining,3,296,201,84,41,43,87,67,47,46,1,2
18-05-2022,CelestialInterface,3,426,116,59,19,40,53,46,37,25,12,1
18-05-2023,ImpactTraining,2,469,430,98,93,5,78,60,9,6,3,0
18-05-2023,Quicksilver,2,842,612,260,254,6,77,66,4,2,2,0
18-05-2023,BitterLaser,3,422,195,214,184,30,69,45,57,29,28,4
18-05-2023,BitterLaser,3,437,20,368,58,310,71,69,25,8,17,0
18-05-2023,Honeycomb,1,162,107,89,10,79,94,61,6,1,5,0
18-05-2023,Aurora,1,570,430,349,332,17,96,73,40,9,31,4
18-05-2023,Honeycomb,3,630,515,16,4,12,79,78,34,23,11,1
18-05-2023,Discovery,3,424,61,105,28,77,64,58,33,19,14,3
18-05-2023,PrimeSeven,2,477,452,231,200,31,56,55,20,10,10,2
18-05-2023,GrayPanthers,3,755,521,413,207,206,70,47,25,8,17,2
18-05-2023,PrimeSeven,3,768,19,651,360,291,71,12,48,8,40,6
18-05-2023,ImpactTraining,1,544,417,170,126,44,65,30,6,0,6,0
18-05-2023,Quicksilver,3,725,717,154,104,50,55,24,28,0,28,2
18-06-2021,Quicksilver,2,783,154,778,479,299,84,35,61,9,52,8
18-06-2021,BitterLaser,2,708,94,72,43,29,67,48,4,2,2,0
18-06-2021,Mustangs,2,513,83,414,248,166,85,36,45,30,15,4
18-06-2021,Honeycomb,2,708,378,349,159,190,82,43,35,5,30,2
18-06-2021,Honeycomb,2,828,789,235,38,197,93,1,6,3,3,0
18-06-2021,BitterLaser,2,501,72,454,289,165,63,10,59,5,54,4
18-06-2021,Mustangs,2,245,131,15,14,1,80,21,16,8,8,0
18-06-2021,Discovery,1,335,121,285,145,140,61,27,22,5,17,1
18-06-2021,Mustangs,2,976,513,432,158,274,60,52,31,13,18,1
18-06-2021,ImpactTraining,2,876,337,816,422,394,67,60,49,31,18,3
18-06-2022,PrimeSeven,1,152,25,48,26,22,100,74,10,0,10,0
18-06-2022,Honeycomb,1,196,36,23,21,2,69,19,19,17,2,0
18-06-2022,Quicksilver,1,754,457,310,27,283,68,64,29,23,6,2
18-06-2022,CelestialInterface,3,274,75,137,80,57,86,41,78,62,16,9
18-06-2022,Mustangs,3,283,109,276,157,119,55,51,25,23,2,0
18-06-2022,PrimeSeven,2,918,879,412,361,51,93,21,36,16,20,1
18-06-2022,Discovery,3,842,276,414,216,198,91,48,65,38,27,3
18-06-2023,Quicksilver,2,516,151,85,41,44,99,97,84,2,82,2
18-06-2023,Mustangs,3,130,3,15,12,3,73,17,19,2,17,1
18-06-2023,CelestialInterface,3,651,470,6,1,5,58,29,33,11,22,1
18-06-2023,GrayPanthers,1,928,542,530,252,278,59,21,46,41,5,0
18-07-2021,PrimeSeven,1,211,21,115,78,37,69,52,29,1,28,3
18-07-2021,Mustangs,2,150,39,25,4,21,76,66,26,5,21,1
18-07-2021,Aurora,3,584,103,179,143,36,97,77,49,32,17,0
18-07-2021,Honeycomb,3,207,98,105,83,22,88,40,60,46,14,0
18-07-2021,ImpactTraining,2,312,24,93,35,58,60,27,31,2,29,0
18-07-2021,Quicksilver,3,340,145,55,30,25,67,1,40,14,26,0
18-07-2021,Quicksilver,3,860,104,551,315,236,96,21,74,73,1,7
18-07-2022,Quicksilver,2,400,42,67,35,32,75,23,18,8,10,0
18-07-2022,Discovery,3,457,293,59,22,37,64,29,25,15,10,0
18-07-2022,CelestialInterface,3,830,822,675,77,598,93,62,69,25,44,1
18-07-2022,PrimeSeven,2,321,22,302,77,225,84,18,53,34,19,5
18-07-2022,Honeycomb,2,649,278,469,1,468,72,32,11,7,4,0
18-07-2022,GrayPanthers,3,831,578,786,437,349,64,31,28,14,14,2
18-07-2022,Mustangs,2,520,142,275,12,263,97,64,45,35,10,2
18-07-2022,PrimeSeven,3,670,57,187,77,110,52,37,24,21,3,0
18-07-2022,Aurora,1,308,27,144,123,21,87,29,13,1,12,0
18-07-2023,ImpactTraining,3,220,202,76,21,55,100,27,61,42,19,6
18-07-2023,Quicksilver,1,683,625,309,136,173,62,32,5,4,1,0
18-07-2023,Honeycomb,1,595,198,365,261,104,51,46,12,3,9,0
18-07-2023,Aurora,3,777,87,585,147,438,61,9,14,7,7,0
18-07-2023,GrayPanthers,3,352,5,55,24,31,70,27,21,14,7,0
18-07-2023,Mustangs,1,132,17,30,17,13,88,21,12,5,7,0
18-07-2023,CelestialInterface,3,848,357,245,197,48,73,57,49,14,35,0
18-08-2021,BitterLaser,2,403,269,229,42,187,92,40,30,20,10,2
18-08-2021,BitterLaser,2,981,780,609,102,507,72,2,12,6,6,0
18-08-2021,CelestialInterface,1,271,109,12,2,10,95,13,29,22,7,0
18-08-2021,ImpactTraining,3,512,33,482,322,160,70,13,32,16,16,3
18-08-2021,Mustangs,2,713,497,246,133,113,84,73,39,3,36,2
18-08-2021,Mustangs,1,297,186,41,10,31,73,6,2,0,2,0
18-08-2021,Mustangs,2,283,174,161,141,20,98,95,90,48,42,4
18-08-2021,Aurora,3,587,6,32,26,6,91,68,2,1,1,0
18-08-2021,Mustangs,1,101,42,55,25,30,87,41,75,38,37,0
18-08-2021,CelestialInterface,2,408,22,369,310,59,83,41,78,50,28,4
18-08-2021,Quicksilver,3,623,555,410,104,306,68,55,35,3,32,2
18-08-2021,Aurora,2,827,243,72,11,61,55,30,32,15,17,0
18-08-2022,CelestialInterface,3,736,179,688,589,99,63,51,37,19,18,1
18-08-2022,GrayPanthers,2,473,254,27,2,25,84,1,0,0,0,0
18-08-2022,Quicksilver,3,656,514,488,147,341,98,72,77,56,21,7
18-08-2023,Honeycomb,2,776,654,501,304,197,70,23,61,3,58,8
18-08-2023,GrayPanthers,2,348,39,83,13,70,68,54,37,19,18,2
18-08-2023,ImpactTraining,3,121,96,62,29,33,89,55,6,1,5,0
18-08-2023,Mustangs,3,914,149,88,35,53,84,25,53,6,47,2
18-08-2023,CelestialInterface,3,617,225,504,300,204,64,43,33,30,3,3
18-08-2023,GrayPanthers,3,872,796,732,599,133,93,51,20,8,12,2
18-08-2023,CelestialInterface,2,390,124,65,18,47,58,54,32,28,4,0
18-08-2023,GrayPanthers,3,323,243,265,49,216,72,41,21,9,12,0
18-08-2023,Honeycomb,1,375,364,31,18,13,76,65,57,31,26,1
18-08-2023,Quicksilver,3,927,115,727,362,365,81,6,36,32,4,2
18-08-2023,Discovery,3,420,74,119,74,45,95,66,76,0,76,5
18-09-2021,Aurora,3,741,144,156,67,89,60,47,28,20,8,3
18-09-2021,Honeycomb,2,233,155,80,72,8,54,0,18,6,12,1
18-09-2021,Quicksilver,2,336,54,195,55,140,81,27,15,9,6,1
18-09-2021,PrimeSeven,2,533,466,148,118,30,84,7,17,7,10,0
18-09-2021,BitterLaser,3,672,30,564,214,350,51,24,47,16,31,4
18-09-2021,CelestialInterface,2,756,431,725,23,702,52,26,11,7,4,0
18-09-2021,CelestialInterface,1,406,60,209,95,114,70,30,42,24,18,0
18-09-2021,GrayPanthers,3,889,20,158,62,96,69,25,57,23,34,5
18-09-2021,Discovery,1,284,261,66,37,29,59,25,27,6,21,2
18-09-2021,PrimeSeven,2,403,244,181,4,177,61,37,43,9,34,1
18-09-2022,Honeycomb,3,165,107,91,57,34,71,1,70,4,66,5
18-09-2022,Honeycomb,3,318,77,241,232,9,84,56,67,1,66,5
18-09-2022,Quicksilver,2,114,32,99,73,26,93,11,73,14,59,7
18-09-2022,BitterLaser,2,693,414,267,149,118,63,44,54,6,48,0
18-09-2022,Quicksilver,1,967,667,901,622,279,90,22,84,13,71,5
18-09-2022,GrayPanthers,1,571,475,119,35,84,58,27,44,40,4,3
18-09-2022,Discovery,1,217,13,84,20,64,92,83,43,29,14,2
18-09-2022,BitterLaser,3,111,35,39,25,14,60,56,38,19,19,0
18-09-2022,Aurora,1,446,26,390,112,278,58,52,53,46,7,5
18-09-2022,PrimeSeven,1,158,134,1,0,1,78,68,12,8,4,0
18-09-2023,ImpactTraining,3,445,327,216,65,151,92,56,6,1,5,0
18-09-2023,Mustangs,1,977,416,693,585,108,65,8,17,13,4,0
18-09-2023,Quicksilver,1,904,97,251,65,186,59,55,47,16,31,6
18-09-2023,Quicksilver,3,402,115,332,231,101,66,65,58,22,36,7
18-09-2023,BitterLaser,3,761,517,330,223,107,99,84,56,3,53,1
18-09-2023,Aurora,1,561,230,304,75,229,91,76,71,6,65,9
18-09-2023,CelestialInterface,3,711,409,306,298,8,83,71,65,2,63,6
18-09-2023,BitterLaser,3,607,30,159,11,148,52,29,3,2,1,0
18-09-2023,CelestialInterface,1,851,190,10,1,9,98,62,80,26,54,9
18-09-2023,GrayPanthers,1,806,56,544,41,503,61,29,29,27,2,2
18-09-2023,ImpactTraining,2,207,18,109,88,21,50,9,1,0,1,0
18-09-2023,ImpactTraining,3,567,18,241,112,129,64,13,9,0,9,0
18-09-2023,Honeycomb,1,399,308,135,117,18,86,51,42,2,40,1
18-09-2023,Mustangs,1,857,46,488,462,26,72,32,36,27,9,0
18-10-2021,Honeycomb,2,668,365,292,22,270,80,40,20,2,18,0
18-10-2021,Honeycomb,3,913,722,830,424,406,82,34,74,51,23,8
18-10-2021,Quicksilver,1,125,110,106,66,40,72,71,5,0,5,0
18-10-2021,ImpactTraining,3,570,325,185,36,149,57,1,25,19,6,1
18-10-2021,Quicksilver,2,769,731,88,17,71,61,43,14,6,8,0
18-10-2021,BitterLaser,1,810,458,584,435,149,80,66,6,2,4,0
18-10-2021,Honeycomb,1,515,480,338,334,4,57,56,12,6,6,0
18-10-2021,Discovery,2,157,55,88,66,22,79,70,60,49,11,6
18-10-2022,Quicksilver,2,365,302,106,59,47,74,73,66,9,57,2
18-10-2022,BitterLaser,2,953,31,36,25,11,66,13,2,0,2,0
18-10-2022,GrayPanthers,1,445,370,304,285,19,58,42,17,16,1,1
18-10-2022,Quicksilver,1,263,91,29,22,7,68,41,52,14,38,5
18-10-2022,Honeycomb,3,719,433,13,12,1,90,39,2,0,2,0
18-10-2022,GrayPanthers,1,145,73,23,2,21,97,92,91,25,66,3
18-10-2022,Discovery,2,847,556,657,298,359,83,72,28,14,14,0
18-10-2022,Quicksilver,1,816,434,92,9,83,68,17,46,23,23,4
18-10-2022,Mustangs,2,802,505,98,47,51,53,3,46,43,3,3
18-10-2023,GrayPanthers,1,163,127,94,56,38,85,50,81,54,27,11
18-10-2023,ImpactTraining,2,676,109,549,278,271,84,21,2,0,2,0
18-10-2023,Quicksilver,2,329,54,214,212,2,79,8,33,11,22,0
18-10-2023,Mustangs,3,352,165,350,62,288,79,3,17,11,6,1
18-10-2023,Honeycomb,1,742,381,448,271,177,98,60,53,49,4,2
18-10-2023,ImpactTraining,2,716,587,474,110,364,90,19,52,29,23,5
18-10-2023,CelestialInterface,3,979,57,810,515,295,53,25,32,19,13,2
18-10-2023,Discovery,3,641,125,633,569,64,74,67,24,23,1,2
18-10-2023,BitterLaser,2,607,144,249,23,226,80,61,38,23,15,0
18-10-2023,ImpactTraining,1,285,3,94,25,69,89,16,20,2,18,0
18-11-2021,Mustangs,3,850,460,258,211,47,50,22,2,1,1,0
18-11-2021,CelestialInterface,3,953,379,903,5,898,72,71,36,20,16,4
18-11-2021,Mustangs,3,256,202,251,52,199,74,48,68,35,33,4
18-11-2021,PrimeSeven,1,978,509,483,77,406,61,21,41,7,34,2
18-11-2021,Honeycomb,2,642,391,135,118,17,79,73,13,1,12,0
18-11-2022,Honeycomb,1,520,300,274,22,252,84,67,32,22,10,0
18-11-2022,Aurora,2,387,227,156,140,16,95,87,76,56,20,3
18-11-2022,Aurora,3,985,608,917,63,854,89,86,66,22,44,2
18-11-2022,Quicksilver,3,897,206,504,185,319,95,58,2,1,1,0
18-11-2022,Mustangs,2,386,288,77,76,1,66,37,28,15,13,1
18-11-2022,CelestialInterface,1,750,336,47,4,43,73,16,46,27,19,2
18-11-2022,Honeycomb,2,192,136,58,12,46,74,10,14,12,2,1
18-11-2022,Quicksilver,2,826,227,138,19,119,63,57,5,3,2,0
18-11-2022,Honeycomb,1,639,371,210,134,76,62,21,40,10,30,0
18-11-2022,Quicksilver,1,472,183,427,111,316,90,73,16,10,6,0
18-11-2022,GrayPanthers,1,880,562,214,20,194,90,60,3,1,2,0
18-11-2023,PrimeSeven,2,937,742,234,192,42,83,2,34,18,16,2
18-11-2023,CelestialInterface,2,680,631,473,397,76,92,11,54,28,26,4
18-11-2023,Quicksilver,2,279,245,222,128,94,51,38,15,12,3,1
18-11-2023,PrimeSeven,1,363,117,240,115,125,59,37,28,15,13,3
18-12-2021,CelestialInterface,1,897,394,307,43,264,87,60,63,48,15,6
18-12-2021,Mustangs,3,248,237,218,4,214,74,6,21,20,1,0
18-12-2021,CelestialInterface,2,508,106,123,83,40,51,42,13,11,2,0
18-12-2021,Honeycomb,2,456,214,443,405,38,51,41,35,15,20,2
18-12-2021,BitterLaser,2,744,371,620,42,578,70,2,51,40,11,1
18-12-2021,PrimeSeven,3,347,191,322,131,191,66,50,3,2,1,0
18-12-2021,Aurora,3,930,504,22,13,9,62,9,3,2,1,0
18-12-2021,GrayPanthers,1,493,76,423,104,319,75,26,39,30,9,4
18-12-2021,GrayPanthers,3,855,459,381,7,374,57,11,27,9,18,1
18-12-2022,Honeycomb,1,412,137,47,4,43,98,15,21,5,16,1
18-12-2022,Aurora,2,492,126,16,10,6,73,38,48,35,13,0
18-12-2022,Honeycomb,2,652,310,196,159,37,56,20,43,35,8,4
18-12-2022,GrayPanthers,2,927,10,875,568,307,58,51,34,11,23,0
18-12-2022,Quicksilver,2,658,112,513,198,315,69,8,45,26,19,3
18-12-2022,GrayPanthers,1,562,283,404,79,325,70,8,4,2,2,0
18-12-2022,GrayPanthers,1,457,436,404,134,270,65,46,59,36,23,1
18-12-2023,Aurora,2,768,241,616,147,469,94,31,52,7,45,1
18-12-2023,Quicksilver,1,580,455,142,116,26,62,56,15,10,5,0
18-12-2023,GrayPanthers,3,688,364,265,108,157,86,55,82,0,82,7
18-12-2023,GrayPanthers,1,132,58,42,23,19,64,3,42,31,11,3
18-12-2023,Aurora,3,191,171,141,7,134,88,18,32,23,9,3
18-12-2023,Honeycomb,3,800,655,415,253,162,91,43,90,85,5,9
18-12-2023,CelestialInterface,1,261,21,132,92,40,70,11,47,22,25,5
18-12-2023,PrimeSeven,2,533,202,419,75,344,99,42,29,9,20,3
19-01-2021,Discovery,2,665,344,483,351,132,75,44,1,0,1,0
19-01-2021,GrayPanthers,3,167,63,2,0,2,91,65,34,11,23,2
19-01-2021,Discovery,3,595,430,3,0,3,69,47,14,6,8,1
19-01-2021,Discovery,2,424,225,302,225,77,63,57,43,21,22,3
19-01-2021,PrimeSeven,3,865,548,12,0,12,77,64,7,3,4,0
19-01-2021,ImpactTraining,3,836,483,459,185,274,59,43,24,2,22,2
19-01-2021,Discovery,1,243,81,236,192,44,73,4,14,6,8,0
19-01-2021,Aurora,1,286,76,86,22,64,77,52,57,31,26,6
19-01-2022,BitterLaser,1,786,396,444,336,108,99,38,91,69,22,12
19-01-2022,Honeycomb,2,625,25,134,2,132,95,64,94,63,31,4
19-01-2022,Honeycomb,1,623,169,563,504,59,84,43,80,24,56,3
19-01-2022,BitterLaser,3,471,422,210,205,5,61,0,24,10,14,1
19-01-2022,BitterLaser,1,587,433,299,19,280,88,84,24,4,20,1
19-01-2022,Honeycomb,2,866,13,407,160,247,71,6,69,37,32,4
19-01-2022,Quicksilver,3,811,353,504,359,145,54,20,21,6,15,0
19-01-2022,Discovery,2,415,73,398,238,160,63,40,52,2,50,6
19-01-2022,Mustangs,1,246,92,33,13,20,77,11,64,55,9,5
19-01-2022,Mustangs,3,482,280,285,24,261,90,27,67,37,30,2
19-01-2022,Honeycomb,2,325,43,261,60,201,58,33,16,4,12,0
19-01-2022,Aurora,2,817,641,332,186,146,63,0,10,0,10,0
19-01-2023,CelestialInterface,2,497,257,223,83,140,88,61,58,38,20,3
19-01-2023,BitterLaser,2,883,228,767,149,618,77,59,19,12,7,1
19-01-2023,CelestialInterface,1,746,365,398,7,391,73,29,35,24,11,4
19-01-2023,Discovery,2,704,101,577,419,158,72,68,2,1,1,0
19-01-2023,Aurora,3,235,146,191,63,128,78,62,65,51,14,4
19-01-2023,PrimeSeven,1,885,568,664,611,53,55,44,37,3,34,4
19-01-2023,Mustangs,2,801,67,19,12,7,76,11,8,7,1,0
19-01-2023,Quicksilver,1,376,265,277,27,250,79,23,16,0,16,0
19-02-2021,GrayPanthers,1,218,185,124,35,89,81,17,58,17,41,4
19-02-2021,Honeycomb,2,311,16,264,93,171,64,52,21,5,16,2
19-02-2021,ImpactTraining,3,248,64,104,9,95,88,64,31,30,1,2
19-02-2021,Discovery,2,846,435,110,83,27,80,56,25,24,1,1
19-02-2022,Honeycomb,2,292,58,70,68,2,60,21,53,29,24,1
19-02-2022,Honeycomb,1,693,253,318,178,140,86,79,19,8,11,1
19-02-2022,Honeycomb,1,438,379,258,31,227,96,15,41,34,7,5
19-02-2022,Mustangs,3,799,171,563,505,58,86,44,70,24,46,3
19-02-2022,GrayPanthers,3,573,310,11,4,7,81,8,26,8,18,1
19-02-2022,BitterLaser,1,399,302,377,242,135,72,12,25,0,25,1
19-02-2022,Aurora,3,908,22,223,43,180,68,15,61,17,44,3
19-02-2022,ImpactTraining,3,444,126,211,198,13,99,66,82,55,27,6
19-02-2022,Aurora,1,382,236,83,66,17,57,46,47,43,4,3
19-02-2023,Mustangs,2,190,59,8,4,4,66,0,52,33,19,5
19-02-2023,ImpactTraining,1,163,55,96,34,62,79,76,48,25,23,4
19-02-2023,Honeycomb,2,394,92,132,48,84,68,25,65,4,61,5
19-02-2023,ImpactTraining,1,650,35,202,26,176,77,56,12,0,12,0
19-02-2023,GrayPanthers,1,495,307,13,10,3,94,66,54,51,3,5
19-02-2023,ImpactTraining,3,534,181,0,0,0,79,36,54,13,41,1
19-02-2023,Aurora,3,949,595,192,112,80,98,72,40,27,13,0
19-02-2023,CelestialInterface,1,583,320,190,179,11,79,23,3,2,1,0
19-02-2023,Discovery,3,679,15,629,236,393,54,45,25,16,9,1
19-02-2023,Aurora,3,778,397,464,30,434,91,6,85,23,62,6
19-02-2023,Quicksilver,2,383,70,270,175,95,59,24,2,0,2,0
19-03-2021,BitterLaser,1,562,1,355,29,326,74,64,36,32,4,0
19-03-2021,Aurora,2,407,235,391,218,173,71,37,17,12,5,0
19-03-2021,Aurora,3,469,49,59,11,48,61,20,55,22,33,7
19-03-2021,Quicksilver,3,177,77,168,114,54,96,19,90,34,56,9
19-03-2021,Honeycomb,2,968,865,116,20,96,83,35,19,1,18,1
19-03-2021,Mustangs,2,814,366,38,36,2,60,59,32,6,26,1
19-03-2021,Honeycomb,1,463,181,241,158,83,62,38,16,3,13,1
19-03-2021,GrayPanthers,3,304,252,9,6,3,88,21,23,13,10,1
19-03-2021,Discovery,1,514,510,482,220,262,78,0,64,56,8,2
19-03-2022,Mustangs,3,700,359,613,389,224,76,34,6,0,6,0
19-03-2022,Discovery,2,147,142,104,99,5,64,26,50,1,49,0
19-03-2022,GrayPanthers,3,961,240,273,217,56,79,58,78,43,35,3
19-03-2022,GrayPanthers,1,233,50,50,7,43,91,11,62,24,38,4
19-03-2022,CelestialInterface,3,775,374,207,72,135,92,58,11,10,1,0
19-03-2022,Discovery,2,212,138,128,26,102,54,52,11,5,6,0
19-03-2022,GrayPanthers,3,356,117,324,182,142,75,6,50,16,34,2
19-03-2022,CelestialInterface,1,705,299,128,35,93,84,14,20,7,13,1
19-03-2022,Honeycomb,1,800,14,144,138,6,87,47,83,82,1,9
19-03-2022,CelestialInterface,2,609,367,45,41,4,58,32,13,7,6,0
19-03-2023,GrayPanthers,3,500,349,128,29,99,92,73,74,51,23,6
19-03-2023,Aurora,1,438,385,240,9,231,78,63,54,0,54,2
19-03-2023,Honeycomb,2,127,17,47,3,44,82,32,71,45,26,8
19-03-2023,CelestialInterface,3,677,172,79,3,76,77,27,25,16,9,2
19-03-2023,ImpactTraining,2,248,42,35,9,26,51,34,35,13,22,1
19-03-2023,Discovery,3,713,260,67,34,33,93,37,6,0,6,0
19-03-2023,ImpactTraining,2,646,553,113,2,111,71,18,67,26,41,8
19-03-2023,Mustangs,2,369,122,233,53,180,93,50,30,12,18,1
19-04-2021,ImpactTraining,2,120,90,1,0,1,51,12,37,11,26,4
19-04-2021,ImpactTraining,3,341,302,254,113,141,96,7,72,34,38,6
19-04-2021,Honeycomb,1,127,50,124,83,41,73,5,31,15,16,3
19-04-2021,PrimeSeven,2,206,92,32,24,8,55,0,5,1,4,0
19-04-2021,Discovery,1,671,167,131,127,4,79,51,73,3,70,6
19-04-2021,GrayPanthers,3,648,241,403,17,386,56,7,34,8,26,2
19-04-2021,Discovery,1,729,442,531,349,182,77,3,16,5,11,0
19-04-2021,CelestialInterface,2,1000,341,611,206,405,62,10,19,0,19,1
19-04-2021,Honeycomb,1,720,31,325,102,223,78,34,4,1,3,0
19-04-2021,ImpactTraining,2,348,61,143,140,3,73,42,18,3,15,1
19-04-2022,CelestialInterface,2,630,88,331,112,219,81,64,4,3,1,0
19-04-2022,BitterLaser,1,616,262,474,65,409,67,14,5,0,5,0
19-04-2022,ImpactTraining,2,415,259,22,19,3,66,6,27,8,19,1
19-04-2022,Honeycomb,3,284,98,184,176,8,73,15,22,19,3,2
19-04-2022,PrimeSeven,1,778,492,525,131,394,83,18,22,11,11,1
19-04-2022,Mustangs,2,473,332,79,45,34,88,76,55,25,30,2
19-04-2022,Discovery,3,949,402,163,22,141,67,46,66,59,7,7
19-04-2022,Discovery,3,585,4,41,33,8,65,18,30,2,28,1
19-04-2022,CelestialInterface,1,592,99,373,242,131,56,28,18,2,16,1
19-04-2022,CelestialInterface,1,456,13,298,177,121,75,4,0,0,0,0
19-04-2022,ImpactTraining,3,574,210,143,35,108,54,5,6,1,5,0
19-04-2022,PrimeSeven,2,833,311,166,58,108,75,42,40,15,25,0
19-04-2022,Discovery,3,323,50,187,100,87,84,66,54,47,7,6
19-04-2023,ImpactTraining,2,834,307,316,39,277,100,18,70,30,40,9
19-04-2023,Mustangs,2,382,93,73,12,61,90,52,71,2,69,5
19-04-2023,Quicksilver,1,919,655,182,50,132,64,36,13,5,8,0
19-04-2023,GrayPanthers,3,476,221,454,103,351,60,10,34,14,20,0
19-04-2023,Honeycomb,1,576,288,522,321,201,85,18,16,15,1,0
19-04-2023,Quicksilver,2,388,206,230,38,192,88,30,75,24,51,1
19-04-2023,Quicksilver,3,271,50,28,0,28,68,64,50,14,36,6
19-04-2023,Quicksilver,3,741,297,88,13,75,64,54,37,31,6,1
19-04-2023,CelestialInterface,2,251,247,186,116,70,72,68,47,1,46,4
19-04-2023,GrayPanthers,3,981,161,930,920,10,73,2,47,17,30,1
19-04-2023,Aurora,3,610,318,113,31,82,64,58,50,12,38,1
19-04-2023,CelestialInterface,2,293,104,193,56,137,92,19,82,24,58,7
19-05-2021,Aurora,2,882,843,296,278,18,64,51,54,4,50,5
19-05-2021,Discovery,3,265,123,93,35,58,58,42,55,46,9,2
19-05-2021,Discovery,1,355,283,112,14,98,61,54,7,4,3,0
19-05-2021,Mustangs,2,478,426,410,251,159,96,13,27,10,17,2
19-05-2022,Honeycomb,1,184,103,98,65,33,74,20,24,18,6,0
19-05-2022,ImpactTraining,3,349,237,269,93,176,71,19,1,0,1,0
19-05-2022,BitterLaser,2,912,96,314,75,239,63,41,14,1,13,1
19-05-2022,Honeycomb,2,331,129,212,154,58,51,25,15,1,14,1
19-05-2022,Honeycomb,3,292,99,191,28,163,87,53,29,24,5,3
19-05-2022,PrimeSeven,3,127,52,58,46,12,64,34,58,16,42,1
19-05-2022,BitterLaser,3,584,131,24,7,17,76,57,6,3,3,0
19-05-2022,Mustangs,1,310,222,53,37,16,80,31,76,75,1,7
19-05-2023,Aurora,2,641,251,219,133,86,67,36,58,53,5,4
19-05-2023,Quicksilver,2,918,488,254,102,152,81,75,10,2,8,0
19-05-2023,Discovery,2,985,896,404,390,14,79,76,76,15,61,6
19-05-2023,Aurora,2,570,226,49,42,7,57,1,55,1,54,0
19-05-2023,Quicksilver,3,607,42,15,6,9,51,31,11,9,2,0
19-05-2023,CelestialInterface,3,833,355,656,173,483,53,39,31,11,20,0
19-05-2023,CelestialInterface,1,364,236,16,0,16,90,58,76,68,8,0
19-05-2023,Honeycomb,2,426,183,258,171,87,91,31,39,33,6,1
19-05-2023,Honeycomb,1,530,275,174,32,142,87,24,67,65,2,3
19-05-2023,BitterLaser,2,425,199,392,39,353,56,47,16,2,14,0
19-05-2023,Aurora,1,1000,835,724,116,608,81,47,6,0,6,0
19-05-2023,Mustangs,1,438,68,370,84,286,69,23,3,1,2,0
19-05-2023,Honeycomb,2,770,332,437,257,180,76,49,48,7,41,1
19-05-2023,PrimeSeven,2,812,284,384,14,370,84,20,44,5,39,1
19-05-2023,GrayPanthers,3,898,622,478,282,196,73,51,37,15,22,4
19-05-2023,CelestialInterface,2,521,407,293,210,83,67,5,60,48,12,3
19-06-2021,CelestialInterface,2,593,201,296,162,134,54,38,11,2,9,0
19-06-2021,Mustangs,3,574,362,422,73,349,60,41,50,21,29,0
19-06-2021,Discovery,1,259,244,44,31,13,77,29,24,7,17,0
19-06-2021,Mustangs,1,477,114,244,138,106,78,66,64,21,43,0
19-06-2021,BitterLaser,1,890,455,361,5,356,91,62,80,2,78,0
19-06-2021,GrayPanthers,1,192,134,65,17,48,100,7,39,12,27,3
19-06-2021,PrimeSeven,2,240,3,226,125,101,77,71,52,18,34,2
19-06-2021,CelestialInterface,1,800,340,576,410,166,75,50,63,19,44,2
19-06-2021,BitterLaser,2,555,175,334,178,156,79,7,33,1,32,0
19-06-2021,Mustangs,3,440,180,127,120,7,62,21,41,6,35,4
19-06-2021,ImpactTraining,1,396,52,195,186,9,62,22,51,4,47,5
19-06-2021,Discovery,2,346,88,67,38,29,95,86,29,11,18,1
19-06-2022,Mustangs,3,258,198,58,47,11,90,44,48,44,4,0
19-06-2022,Aurora,3,156,99,148,144,4,56,18,2,0,2,0
19-06-2022,Aurora,3,746,540,574,440,134,65,35,5,3,2,0
19-06-2022,BitterLaser,3,426,230,409,233,176,65,63,0,0,0,0
19-06-2022,CelestialInterface,2,107,43,84,17,67,50,33,43,13,30,0
19-06-2023,Mustangs,1,830,677,176,150,26,69,64,38,7,31,3
19-06-2023,Aurora,3,311,101,83,69,14,72,17,59,15,44,0
19-06-2023,Quicksilver,2,708,356,676,441,235,52,9,14,4,10,1
19-06-2023,Honeycomb,2,571,154,474,4,470,70,17,34,4,30,1
19-06-2023,BitterLaser,3,622,387,357,47,310,50,30,23,7,16,1
19-06-2023,Discovery,1,993,392,385,109,276,56,42,40,1,39,4
19-06-2023,ImpactTraining,3,808,236,49,2,47,65,57,2,1,1,0
19-06-2023,CelestialInterface,3,955,557,754,420,334,89,68,5,4,1,0
19-06-2023,CelestialInterface,1,318,135,68,21,47,90,0,79,13,66,4
19-06-2023,Aurora,1,732,495,146,133,13,82,41,51,50,1,3
19-06-2023,PrimeSeven,2,383,265,185,90,95,64,59,50,36,14,4
19-06-2023,Honeycomb,2,670,533,107,74,33,56,37,13,0,13,0
19-07-2021,Aurora,3,537,463,521,215,306,63,7,0,0,0,0
19-07-2021,ImpactTraining,2,691,295,164,65,99,66,44,11,3,8,0
19-07-2021,ImpactTraining,3,997,349,815,789,26,77,10,1,0,1,0
19-07-2021,PrimeSeven,3,725,614,689,625,64,95,3,54,11,43,3
19-07-2021,PrimeSeven,3,913,234,417,393,24,57,56,48,44,4,3
19-07-2021,Aurora,3,358,162,150,77,73,100,28,96,82,14,3
19-07-2021,ImpactTraining,3,996,580,72,17,55,95,30,16,10,6,1
19-07-2021,CelestialInterface,2,162,52,135,86,49,71,23,39,36,3,2
19-07-2022,Honeycomb,2,670,215,204,56,148,94,67,86,57,29,2
19-07-2022,Honeycomb,2,991,154,765,196,569,66,39,48,0,48,4
19-07-2022,Aurora,1,398,140,262,146,116,51,49,45,34,11,4
19-07-2022,PrimeSeven,2,889,833,145,41,104,96,87,28,24,4,2
19-07-2022,PrimeSeven,1,802,21,342,180,162,69,47,36,20,16,0
19-07-2022,Discovery,3,920,733,515,28,487,73,8,23,0,23,0
19-07-2022,GrayPanthers,1,703,633,59,37,22,52,6,51,19,32,3
19-07-2022,ImpactTraining,2,421,367,382,225,157,64,29,25,11,14,2
19-07-2022,PrimeSeven,1,729,613,679,71,608,61,13,23,21,2,1
19-07-2022,CelestialInterface,2,259,167,206,29,177,51,29,49,46,3,2
19-07-2023,PrimeSeven,1,844,796,611,289,322,73,22,31,4,27,2
19-07-2023,ImpactTraining,1,686,391,305,219,86,86,20,7,0,7,0
19-07-2023,CelestialInterface,2,220,156,72,48,24,87,14,18,16,2,0
19-07-2023,GrayPanthers,1,257,204,50,9,41,91,53,53,22,31,1
19-07-2023,PrimeSeven,1,430,207,253,88,165,76,43,65,61,4,0
19-07-2023,Quicksilver,1,431,411,398,260,138,94,47,65,15,50,8
19-07-2023,Mustangs,3,591,157,426,255,171,60,6,4,1,3,0
19-07-2023,Quicksilver,3,516,441,291,103,188,78,38,47,9,38,2
19-07-2023,Mustangs,1,934,517,698,554,144,51,38,37,17,20,3
19-07-2023,Aurora,2,903,280,37,6,31,70,8,32,9,23,0
19-08-2021,Honeycomb,3,702,613,679,659,20,85,37,0,0,0,0
19-08-2021,Honeycomb,2,422,165,390,285,105,96,79,41,37,4,2
19-08-2021,CelestialInterface,1,405,39,49,41,8,91,24,85,76,9,0
19-08-2021,Honeycomb,1,706,571,7,4,3,66,1,39,33,6,0
19-08-2021,Honeycomb,2,851,479,393,205,188,60,3,7,4,3,0
19-08-2021,Mustangs,3,836,830,121,33,88,98,83,68,47,21,0
19-08-2021,PrimeSeven,2,145,8,41,1,40,65,36,57,54,3,4
19-08-2021,Aurora,2,604,456,408,301,107,67,14,13,3,10,0
19-08-2021,Aurora,3,111,71,65,48,17,93,1,90,16,74,5
19-08-2021,BitterLaser,1,862,298,263,87,176,75,66,29,4,25,1
19-08-2021,ImpactTraining,2,367,169,106,75,31,52,12,15,2,13,1
19-08-2021,BitterLaser,3,519,284,377,254,123,57,4,43,31,12,0
19-08-2022,ImpactTraining,2,382,85,13,0,13,81,73,56,52,4,1
19-08-2022,Honeycomb,2,373,95,160,128,32,51,3,37,23,14,2
19-08-2022,BitterLaser,1,502,143,167,53,114,89,9,5,0,5,0
19-08-2022,Aurora,2,715,361,516,180,336,56,3,19,17,2,1
19-08-2022,GrayPanthers,2,883,753,348,83,265,55,34,16,4,12,0
19-08-2022,Honeycomb,2,153,8,134,44,90,95,92,83,73,10,7
19-08-2022,Discovery,1,897,781,756,384,372,65,37,36,24,12,3
19-08-2022,BitterLaser,2,538,94,315,149,166,75,69,16,14,2,0
19-08-2022,Discovery,2,423,248,91,74,17,87,15,78,34,44,2
19-08-2022,Honeycomb,2,698,505,100,45,55,53,3,31,13,18,1
19-08-2023,Mustangs,3,956,276,202,54,148,71,37,51,20,31,5
19-08-2023,GrayPanthers,3,951,155,759,575,184,82,10,25,21,4,1
19-08-2023,Honeycomb,3,448,428,132,92,40,88,33,15,1,14,0
19-08-2023,Quicksilver,3,636,160,34,23,11,87,61,79,37,42,10
19-08-2023,Honeycomb,2,993,653,107,75,32,73,23,7,2,5,0
19-08-2023,GrayPanthers,2,774,717,430,326,104,53,31,26,6,20,2
19-08-2023,Aurora,1,802,571,400,45,355,70,50,37,16,21,3
19-09-2021,Honeycomb,3,591,277,567,442,125,84,83,74,31,43,4
19-09-2021,Honeycomb,3,396,285,82,42,40,99,19,14,2,12,0
19-09-2021,GrayPanthers,3,275,29,18,1,17,58,37,13,3,10,0
19-09-2021,Mustangs,2,246,116,21,1,20,92,55,39,10,29,4
19-09-2021,ImpactTraining,3,873,707,340,37,303,50,27,38,16,22,1
19-09-2021,CelestialInterface,2,353,262,95,78,17,76,28,71,32,39,5
19-09-2021,Quicksilver,1,226,192,54,52,2,80,53,17,6,11,1
19-09-2021,Discovery,1,115,51,114,109,5,99,74,71,12,59,0
19-09-2022,Aurora,2,722,497,413,391,22,66,39,44,6,38,0
19-09-2022,Honeycomb,3,194,114,41,11,30,80,60,62,59,3,0
19-09-2022,Discovery,1,835,449,557,387,170,57,32,4,2,2,0
19-09-2022,Honeycomb,2,709,285,575,494,81,52,41,19,9,10,0
19-09-2022,BitterLaser,1,683,247,104,50,54,99,4,12,1,11,0
19-09-2023,Aurora,1,898,535,124,86,38,100,27,76,9,67,5
19-09-2023,ImpactTraining,3,287,211,238,236,2,51,50,27,15,12,1
19-09-2023,GrayPanthers,3,278,90,141,44,97,57,1,16,11,5,1
19-09-2023,PrimeSeven,1,541,199,469,251,218,84,11,40,17,23,5
19-09-2023,Honeycomb,1,689,146,434,355,79,56,20,13,8,5,0
19-09-2023,BitterLaser,1,941,787,676,595,81,98,7,25,21,4,0
19-09-2023,PrimeSeven,3,257,185,230,141,89,72,9,28,27,1,3
19-09-2023,ImpactTraining,2,468,391,152,41,111,84,82,78,30,48,8
19-09-2023,GrayPanthers,2,600,453,443,164,279,51,5,7,5,2,0
19-09-2023,Quicksilver,2,340,258,23,1,22,51,5,40,11,29,0
19-09-2023,Mustangs,3,390,137,170,88,82,94,30,74,29,45,9
19-09-2023,ImpactTraining,3,449,137,174,91,83,51,41,18,14,4,0
19-09-2023,Discovery,3,834,298,164,8,156,90,89,23,15,8,0
19-09-2023,Discovery,3,896,495,509,127,382,60,13,27,18,9,1
19-09-2023,Discovery,1,337,220,132,120,12,80,34,15,4,11,1
19-10-2021,PrimeSeven,2,696,281,444,67,377,62,8,36,31,5,2
19-10-2021,Discovery,3,234,80,202,176,26,68,61,13,12,1,0
19-10-2021,Honeycomb,3,539,159,453,155,298,95,74,91,44,47,1
19-10-2021,CelestialInterface,3,373,204,219,57,162,74,2,50,17,33,3
19-10-2021,Discovery,1,731,467,264,247,17,62,55,34,31,3,3
19-10-2021,Discovery,1,917,493,794,740,54,99,4,39,1,38,4
19-10-2021,Mustangs,1,764,560,441,409,32,100,69,27,18,9,1
19-10-2021,BitterLaser,1,872,263,591,321,270,56,12,46,36,10,1
19-10-2021,CelestialInterface,2,895,451,853,624,229,82,27,74,55,19,6
19-10-2021,CelestialInterface,1,389,3,44,12,32,89,38,2,0,2,0
19-10-2021,Discovery,3,510,357,366,319,47,64,39,61,12,49,1
19-10-2021,Honeycomb,1,246,82,170,46,124,56,40,33,16,17,2
19-10-2021,BitterLaser,3,291,93,37,35,2,90,1,18,6,12,0
19-10-2021,GrayPanthers,1,479,417,309,193,116,83,15,34,29,5,0
19-10-2021,Quicksilver,3,271,26,247,89,158,96,33,52,29,23,5
19-10-2021,GrayPanthers,1,115,88,4,1,3,51,35,2,1,1,0
19-10-2021,BitterLaser,3,828,541,180,18,162,84,31,39,6,33,1
19-10-2021,BitterLaser,3,159,42,40,13,27,76,50,66,54,12,5
19-10-2022,GrayPanthers,3,529,416,245,116,129,92,4,42,13,29,0
19-10-2022,GrayPanthers,2,987,884,704,613,91,69,7,3,2,1,0
19-10-2022,Quicksilver,3,779,330,224,137,87,100,31,11,1,10,0
19-10-2022,Aurora,2,150,6,41,27,14,66,53,35,3,32,3
19-10-2022,Discovery,1,994,958,772,286,486,74,5,73,36,37,4
19-10-2022,GrayPanthers,1,715,429,390,79,311,66,47,26,16,10,1
19-10-2022,ImpactTraining,1,149,14,121,46,75,74,37,13,7,6,0
19-10-2022,GrayPanthers,2,847,267,396,275,121,67,9,30,17,13,2
19-10-2023,PrimeSeven,1,908,404,54,25,29,68,67,36,17,19,2
19-10-2023,Aurora,2,827,100,38,33,5,74,0,21,2,19,1
19-10-2023,PrimeSeven,2,545,453,396,93,303,91,58,50,4,46,5
19-10-2023,GrayPanthers,2,984,95,814,393,421,62,40,12,6,6,0
19-10-2023,PrimeSeven,1,564,65,26,1,25,96,76,1,0,1,0
19-10-2023,CelestialInterface,2,921,183,867,846,21,69,55,31,26,5,2
19-10-2023,Quicksilver,3,191,30,99,89,10,87,7,51,30,21,4
19-10-2023,Honeycomb,2,849,630,841,227,614,91,33,74,14,60,7
19-10-2023,CelestialInterface,2,349,178,293,16,277,100,34,99,5,94,1
19-10-2023,ImpactTraining,2,951,61,938,602,336,82,21,11,6,5,0
19-10-2023,Aurora,3,276,96,91,11,80,83,25,34,25,9,4
19-10-2023,GrayPanthers,1,929,77,808,131,677,94,40,60,56,4,2
19-11-2021,Mustangs,1,837,232,118,36,82,92,88,0,0,0,0
19-11-2021,Honeycomb,3,451,23,61,16,45,57,10,28,0,28,3
19-11-2021,Aurora,1,685,437,137,52,85,52,47,26,12,14,2
19-11-2021,Aurora,2,662,116,457,451,6,96,87,87,20,67,7
19-11-2021,BitterLaser,3,121,7,79,25,54,65,48,16,9,7,1
19-11-2021,Honeycomb,1,225,167,65,39,26,100,77,9,1,8,0
19-11-2021,Honeycomb,2,633,285,148,114,34,54,52,38,26,12,1
19-11-2021,Mustangs,2,218,104,42,35,7,77,32,6,4,2,0
19-11-2021,ImpactTraining,3,463,17,356,192,164,68,63,22,4,18,1
19-11-2022,Mustangs,2,162,110,114,53,61,98,50,71,6,65,1
19-11-2022,Honeycomb,1,731,582,160,12,148,57,25,38,25,13,0
19-11-2022,Quicksilver,2,149,134,59,52,7,51,8,12,2,10,0
19-11-2022,ImpactTraining,3,563,163,298,232,66,85,25,41,16,25,4
19-11-2022,Mustangs,1,962,357,605,78,527,97,32,56,42,14,1
19-11-2022,Quicksilver,3,708,697,102,43,59,68,42,37,9,28,0
19-11-2023,ImpactTraining,1,193,42,95,63,32,98,91,24,19,5,1
19-11-2023,ImpactTraining,1,606,292,106,17,89,76,57,40,21,19,1
19-11-2023,BitterLaser,3,194,94,152,52,100,85,29,47,26,21,0
19-11-2023,Mustangs,3,734,541,31,21,10,55,9,25,14,11,1
19-11-2023,PrimeSeven,1,284,137,139,32,107,69,20,34,24,10,4
19-11-2023,Honeycomb,2,459,374,92,14,78,95,64,30,8,22,0
19-11-2023,PrimeSeven,3,703,378,135,58,77,60,15,40,0,40,0
19-11-2023,PrimeSeven,3,516,461,512,209,303,55,10,50,18,32,3
19-12-2021,GrayPanthers,2,209,63,98,44,54,65,5,13,11,2,0
19-12-2021,CelestialInterface,2,247,93,143,99,44,55,29,39,12,27,3
19-12-2021,PrimeSeven,3,207,67,54,13,41,79,1,37,5,32,0
19-12-2021,ImpactTraining,3,142,141,101,46,55,90,71,42,7,35,2
19-12-2021,Mustangs,1,655,649,204,21,183,74,36,24,12,12,2
19-12-2021,PrimeSeven,1,565,114,372,114,258,69,31,47,46,1,1
19-12-2021,Quicksilver,2,958,517,840,350,490,75,54,39,19,20,0
19-12-2021,PrimeSeven,3,470,377,279,194,85,56,9,4,3,1,0
19-12-2022,BitterLaser,1,141,85,132,69,63,54,48,8,5,3,0
19-12-2022,BitterLaser,3,536,160,134,88,46,82,29,53,19,34,2
19-12-2022,BitterLaser,3,401,317,326,53,273,72,55,55,14,41,4
19-12-2022,BitterLaser,3,415,39,241,112,129,96,86,16,14,2,0
19-12-2022,PrimeSeven,2,540,168,143,22,121,94,21,47,10,37,2
19-12-2022,GrayPanthers,1,830,636,419,229,190,61,16,32,7,25,2
19-12-2022,CelestialInterface,3,493,35,210,195,15,61,42,60,35,25,8
19-12-2022,BitterLaser,1,256,91,146,117,29,88,57,60,31,29,7
19-12-2022,CelestialInterface,1,774,157,78,9,69,69,57,25,0,25,0
19-12-2022,GrayPanthers,1,350,258,136,29,107,79,63,18,13,5,1
19-12-2023,ImpactTraining,3,858,447,655,468,187,65,61,3,0,3,0
19-12-2023,Discovery,1,857,186,374,207,167,85,80,65,45,20,8
19-12-2023,Discovery,2,494,104,107,50,57,56,6,49,17,32,4
19-12-2023,CelestialInterface,2,617,71,101,11,90,96,10,91,39,52,4
19-12-2023,Mustangs,1,995,751,687,603,84,70,50,63,38,25,6
19-12-2023,Quicksilver,2,411,400,103,86,17,92,21,32,20,12,1
19-12-2023,Aurora,2,667,332,301,291,10,84,23,13,8,5,0
19-12-2023,Discovery,1,988,691,383,176,207,82,22,68,64,4,6
19-12-2023,Quicksilver,3,702,619,3,2,1,95,33,60,46,14,1
20-01-2021,BitterLaser,1,324,252,151,78,73,78,43,11,4,7,0
20-01-2021,CelestialInterface,2,862,406,451,358,93,51,33,30,28,2,1
20-01-2021,Quicksilver,1,367,151,302,53,249,53,43,6,0,6,0
20-01-2021,Discovery,3,101,66,29,27,2,65,51,44,13,31,4
20-01-2021,Discovery,2,399,243,300,61,239,69,23,61,48,13,2
20-01-2021,Aurora,2,262,22,34,24,10,82,32,12,5,7,0
20-01-2021,Quicksilver,3,418,376,223,48,175,62,31,35,30,5,4
20-01-2021,Mustangs,2,471,196,261,199,62,69,66,65,57,8,2
20-01-2022,BitterLaser,2,528,38,308,272,36,74,29,3,1,2,0
20-01-2022,CelestialInterface,1,705,656,637,10,627,76,31,45,4,41,4
20-01-2022,PrimeSeven,1,600,284,527,518,9,54,48,44,22,22,4
20-01-2022,BitterLaser,1,889,845,394,165,229,72,56,64,32,32,2
20-01-2022,Aurora,2,940,14,714,187,527,98,96,9,6,3,0
20-01-2022,Discovery,1,676,581,29,17,12,71,66,8,6,2,0
20-01-2022,Aurora,2,607,44,356,229,127,59,31,27,23,4,0
20-01-2022,Honeycomb,1,898,195,848,516,332,87,38,66,20,46,0
20-01-2023,CelestialInterface,1,881,696,676,397,279,92,22,37,36,1,4
20-01-2023,ImpactTraining,2,926,370,784,371,413,74,9,52,24,28,1
20-01-2023,Mustangs,2,548,329,17,16,1,91,16,17,4,13,1
20-01-2023,CelestialInterface,1,397,61,332,93,239,79,48,52,45,7,5
20-01-2023,PrimeSeven,1,456,387,209,156,53,87,17,61,15,46,7
20-01-2023,Discovery,2,862,219,637,192,445,78,14,54,35,19,3
20-01-2023,GrayPanthers,2,476,34,106,9,97,75,53,55,36,19,7
20-01-2023,Mustangs,1,184,99,159,108,51,87,64,32,27,5,0
20-01-2023,Mustangs,3,985,949,410,318,92,81,68,73,28,45,2
20-01-2023,Honeycomb,3,617,148,240,21,219,59,21,7,1,6,0
20-01-2023,PrimeSeven,1,610,156,56,34,22,61,19,47,35,12,6
20-01-2023,Mustangs,3,294,240,202,157,45,69,31,0,0,0,0
20-02-2021,Honeycomb,3,476,189,398,336,62,99,98,58,32,26,6
20-02-2021,Quicksilver,3,589,218,341,119,222,95,9,80,18,62,9
20-02-2021,BitterLaser,3,364,147,174,97,77,74,53,31,27,4,2
20-02-2021,ImpactTraining,2,570,128,15,4,11,51,39,4,2,2,0
20-02-2021,CelestialInterface,1,227,108,66,53,13,98,92,39,34,5,0
20-02-2021,Discovery,2,728,431,125,81,44,98,33,29,27,2,0
20-02-2021,Discovery,2,576,141,358,78,280,61,49,59,6,53,2
20-02-2021,Discovery,1,480,143,194,0,194,74,41,60,58,2,4
20-02-2021,CelestialInterface,1,117,97,60,48,12,98,14,75,5,70,2
20-02-2021,GrayPanthers,2,552,82,323,164,159,76,4,42,12,30,2
20-02-2022,Quicksilver,1,848,344,503,302,201,50,15,19,5,14,1
20-02-2022,Honeycomb,3,995,189,582,536,46,79,62,32,23,9,3
20-02-2022,Aurora,3,494,400,423,113,310,90,51,6,5,1,0
20-02-2022,Honeycomb,3,449,209,46,13,33,80,29,38,19,19,4
20-02-2022,PrimeSeven,1,569,145,468,460,8,85,35,3,0,3,0
20-02-2022,CelestialInterface,1,705,457,117,38,79,69,12,55,2,53,7
20-02-2022,BitterLaser,2,793,473,145,10,135,59,10,8,2,6,0
20-02-2022,Aurora,2,581,157,174,118,56,75,65,66,57,9,4
20-02-2023,Quicksilver,1,302,63,261,106,155,57,3,44,28,16,4
20-02-2023,BitterLaser,2,203,196,173,171,2,90,54,84,5,79,10
20-02-2023,ImpactTraining,1,425,179,402,104,298,97,29,11,0,11,0
20-02-2023,Quicksilver,3,223,219,200,69,131,95,81,34,5,29,3
20-02-2023,Aurora,2,917,205,886,154,732,92,63,11,6,5,0
20-02-2023,Honeycomb,1,136,68,101,55,46,59,42,58,42,16,6
20-02-2023,Mustangs,2,682,416,107,70,37,58,18,17,10,7,1
20-02-2023,PrimeSeven,3,552,90,395,95,300,64,42,50,22,28,1
20-02-2023,Aurora,1,313,280,101,17,84,99,46,15,1,14,0
20-03-2021,Quicksilver,2,332,78,239,163,76,89,60,16,7,9,0
20-03-2021,ImpactTraining,2,670,545,227,178,49,59,4,48,45,3,3
20-03-2021,CelestialInterface,1,481,87,471,29,442,89,30,0,0,0,0
20-03-2021,Quicksilver,2,244,51,161,141,20,71,68,25,0,25,1
20-03-2021,Quicksilver,3,883,797,24,8,16,58,37,8,7,1,0
20-03-2021,BitterLaser,1,584,108,173,106,67,94,41,37,13,24,4
20-03-2021,PrimeSeven,1,862,854,437,50,387,90,11,76,64,12,9
20-03-2022,Discovery,2,326,229,129,2,127,96,62,32,19,13,3
20-03-2022,Discovery,1,464,214,406,224,182,74,32,28,27,1,3
20-03-2022,Quicksilver,1,144,138,40,31,9,77,63,44,36,8,5
20-03-2022,Discovery,2,914,657,256,51,205,58,43,38,20,18,3
20-03-2022,BitterLaser,3,167,164,30,12,18,99,11,36,34,2,0
20-03-2022,CelestialInterface,2,850,318,662,211,451,99,51,45,24,21,4
20-03-2022,Quicksilver,3,902,638,563,231,332,63,34,17,6,11,1
20-03-2022,Discovery,1,666,641,79,2,77,75,54,74,72,2,4
20-03-2023,ImpactTraining,2,411,178,259,41,218,99,70,24,16,8,0
20-03-2023,BitterLaser,1,532,451,297,139,158,86,35,35,5,30,3
20-03-2023,ImpactTraining,1,770,330,657,436,221,55,23,47,4,43,3
20-03-2023,Mustangs,3,728,505,463,257,206,84,45,52,35,17,1
20-03-2023,PrimeSeven,1,750,451,91,47,44,57,13,33,18,15,1
20-03-2023,Aurora,2,964,630,108,26,82,68,1,11,4,7,0
20-03-2023,Mustangs,1,888,610,735,474,261,86,32,71,65,6,0
20-03-2023,PrimeSeven,1,461,248,439,215,224,65,33,3,2,1,0
20-03-2023,Honeycomb,3,914,130,594,585,9,90,16,13,1,12,0
20-03-2023,Quicksilver,2,908,846,358,300,58,99,76,80,78,2,3
20-04-2021,CelestialInterface,3,237,148,139,15,124,94,50,23,17,6,1
20-04-2021,Quicksilver,2,462,145,448,187,261,88,75,72,54,18,2
20-04-2021,ImpactTraining,2,568,133,293,77,216,80,16,51,42,9,1
20-04-2021,GrayPanthers,1,456,49,394,368,26,64,33,44,26,18,3
20-04-2021,Aurora,3,411,375,142,114,28,68,21,63,42,21,6
20-04-2022,ImpactTraining,1,446,19,419,43,376,71,40,63,7,56,0
20-04-2022,Discovery,1,805,489,312,166,146,60,39,52,25,27,1
20-04-2022,Discovery,2,842,137,217,98,119,71,51,29,7,22,3
20-04-2022,Aurora,3,516,256,40,29,11,96,24,85,64,21,3
20-04-2022,PrimeSeven,2,594,335,226,20,206,72,18,56,51,5,4
20-04-2022,BitterLaser,1,800,74,424,91,333,66,61,40,4,36,4
20-04-2022,CelestialInterface,1,975,137,833,332,501,50,31,47,1,46,6
20-04-2022,GrayPanthers,2,729,305,435,84,351,97,48,85,16,69,6
20-04-2022,CelestialInterface,3,142,116,58,33,25,56,42,45,20,25,1
20-04-2022,BitterLaser,2,625,133,301,117,184,84,82,40,32,8,4
20-04-2022,CelestialInterface,3,209,15,136,83,53,90,61,56,52,4,5
20-04-2023,Mustangs,2,641,26,65,55,10,87,34,25,7,18,2
20-04-2023,PrimeSeven,3,601,127,6,3,3,53,20,51,26,25,2
20-04-2023,Discovery,1,289,281,268,58,210,84,49,8,4,4,0
20-05-2021,Discovery,1,995,297,242,66,176,79,64,3,0,3,0
20-05-2021,Quicksilver,1,628,412,401,75,326,81,48,27,24,3,2
20-05-2021,BitterLaser,1,485,397,295,169,126,67,55,5,3,2,0
20-05-2021,Honeycomb,3,648,517,424,169,255,83,26,72,41,31,2
20-05-2021,Quicksilver,1,402,83,115,51,64,55,26,43,37,6,1
20-05-2021,Quicksilver,3,911,177,885,658,227,73,6,39,16,23,4
20-05-2021,ImpactTraining,3,785,554,416,23,393,65,5,53,48,5,3
20-05-2021,CelestialInterface,3,888,538,748,746,2,96,7,16,8,8,1
20-05-2021,Discovery,2,981,214,825,519,306,69,19,36,14,22,1
20-05-2021,PrimeSeven,1,231,139,205,156,49,68,35,20,3,17,0
20-05-2021,GrayPanthers,2,303,269,227,112,115,75,39,63,18,45,8
20-05-2021,Mustangs,3,872,251,128,11,117,69,66,40,21,19,0
20-05-2021,CelestialInterface,1,541,367,467,312,155,96,82,73,48,25,4
20-05-2022,GrayPanthers,2,761,201,654,584,70,88,27,45,17,28,2
20-05-2022,ImpactTraining,2,822,216,576,272,304,71,37,29,15,14,3
20-05-2022,GrayPanthers,1,939,734,883,266,617,93,35,45,22,23,3
20-05-2022,Quicksilver,2,393,251,274,38,236,54,24,32,17,15,2
20-05-2022,Aurora,1,618,201,105,78,27,76,52,62,15,47,3
20-05-2022,PrimeSeven,1,336,48,99,9,90,52,3,0,0,0,0
20-05-2022,BitterLaser,1,576,490,303,212,91,93,89,29,3,26,0
20-05-2023,GrayPanthers,2,204,126,130,2,128,69,11,39,9,30,1
20-05-2023,ImpactTraining,2,220,79,18,5,13,50,37,17,2,15,1
20-05-2023,BitterLaser,3,157,125,81,8,73,97,40,32,27,5,0
20-05-2023,Quicksilver,3,947,941,599,44,555,61,45,18,12,6,1
20-05-2023,Discovery,2,211,135,28,5,23,73,69,9,6,3,0
20-05-2023,Honeycomb,3,546,149,6,5,1,65,2,49,33,16,3
20-05-2023,Honeycomb,3,919,308,457,411,46,60,15,44,28,16,2
20-05-2023,BitterLaser,3,325,298,309,216,93,89,62,62,9,53,3
20-05-2023,CelestialInterface,2,785,712,355,246,109,55,24,51,20,31,3
20-05-2023,Aurora,2,284,31,103,7,96,50,2,18,8,10,1
20-05-2023,PrimeSeven,2,606,302,175,89,86,87,68,20,13,7,1
20-06-2021,Quicksilver,3,908,449,312,34,278,63,34,49,39,10,0
20-06-2021,Mustangs,1,639,389,111,109,2,51,28,45,2,43,0
20-06-2021,Mustangs,2,828,636,361,272,89,83,69,62,61,1,0
20-06-2021,BitterLaser,2,154,118,108,83,25,96,77,7,6,1,0
20-06-2021,Discovery,2,818,633,615,56,559,63,28,41,3,38,3
20-06-2021,Aurora,3,363,185,162,98,64,68,30,52,22,30,3
20-06-2021,Honeycomb,1,969,664,486,19,467,93,4,38,33,5,2
20-06-2022,Mustangs,3,764,605,604,131,473,83,37,31,11,20,3
20-06-2022,Honeycomb,3,284,141,231,84,147,52,17,5,3,2,0
20-06-2022,Discovery,2,914,317,185,40,145,75,17,8,3,5,0
20-06-2022,GrayPanthers,2,444,438,112,17,95,56,47,39,31,8,1
20-06-2022,Mustangs,1,117,67,62,45,17,58,4,55,8,47,6
20-06-2022,PrimeSeven,3,144,95,14,3,11,89,23,59,0,59,2
20-06-2023,ImpactTraining,1,742,440,314,122,192,99,35,24,18,6,0
20-06-2023,CelestialInterface,1,501,142,354,158,196,58,43,7,4,3,0
20-06-2023,Discovery,3,820,621,46,22,24,83,64,19,14,5,0
20-06-2023,Honeycomb,2,297,30,248,174,74,96,38,66,4,62,7
20-06-2023,BitterLaser,1,192,120,165,74,91,99,67,25,0,25,1
20-06-2023,GrayPanthers,3,433,109,94,78,16,69,38,43,6,37,2
20-06-2023,Mustangs,2,784,220,60,11,49,96,54,0,0,0,0
20-06-2023,CelestialInterface,2,572,446,553,541,12,98,71,11,9,2,0
20-06-2023,Honeycomb,1,752,80,553,407,146,53,4,31,2,29,2
20-06-2023,Discovery,3,150,52,72,3,69,95,76,39,21,18,3
20-06-2023,Discovery,1,792,106,207,197,10,60,49,6,5,1,0
20-07-2021,GrayPanthers,1,910,176,694,659,35,95,4,17,11,6,0
20-07-2021,Honeycomb,2,108,2,65,18,47,70,51,11,2,9,0
20-07-2021,GrayPanthers,2,694,337,579,310,269,73,12,6,2,4,0
20-07-2021,ImpactTraining,3,640,86,614,465,149,56,50,16,9,7,0
20-07-2021,Mustangs,1,990,290,256,209,47,77,10,40,17,23,4
20-07-2021,Aurora,3,216,103,58,45,13,57,23,27,25,2,1
20-07-2021,ImpactTraining,2,805,613,501,339,162,57,54,2,0,2,0
20-07-2021,ImpactTraining,3,652,648,332,286,46,77,12,45,13,32,0
20-07-2021,Aurora,1,247,215,87,14,73,82,55,5,4,1,0
20-07-2021,ImpactTraining,2,612,26,535,500,35,82,71,34,3,31,2
20-07-2021,Discovery,1,254,248,111,30,81,88,23,9,6,3,0
20-07-2022,Discovery,1,879,681,149,69,80,73,54,25,2,23,1
20-07-2022,BitterLaser,2,945,619,72,66,6,93,33,59,7,52,6
20-07-2022,Honeycomb,1,670,49,408,217,191,73,2,34,32,2,2
20-07-2022,Mustangs,2,309,56,254,124,130,68,1,0,0,0,0
20-07-2022,CelestialInterface,1,605,433,454,421,33,71,53,59,46,13,2
20-07-2022,Discovery,3,359,13,124,83,41,72,4,38,37,1,2
20-07-2022,Mustangs,2,971,261,199,89,110,51,38,25,7,18,2
20-07-2022,Honeycomb,1,516,45,345,329,16,69,55,34,21,13,0
20-07-2023,Quicksilver,2,974,639,839,327,512,81,37,25,2,23,2
20-07-2023,Quicksilver,1,366,333,142,17,125,79,69,9,7,2,0
20-07-2023,BitterLaser,2,135,26,75,36,39,71,62,23,18,5,2
20-07-2023,Quicksilver,1,728,387,626,399,227,56,53,50,3,47,6
20-07-2023,Honeycomb,1,939,751,36,19,17,98,85,56,40,16,6
20-07-2023,Honeycomb,3,131,100,31,12,19,75,9,12,7,5,0
20-07-2023,GrayPanthers,2,787,777,325,42,283,82,43,19,0,19,0
20-07-2023,ImpactTraining,1,574,566,112,85,27,92,62,36,11,25,1
20-07-2023,ImpactTraining,3,541,278,227,118,109,91,34,29,13,16,2
20-07-2023,Mustangs,1,275,235,75,61,14,83,23,32,16,16,2
20-07-2023,ImpactTraining,2,778,168,255,139,116,100,11,50,17,33,1
20-07-2023,Aurora,3,716,318,130,50,80,81,53,61,3,58,4
20-07-2023,Discovery,2,265,46,198,52,146,77,28,17,4,13,1
20-07-2023,ImpactTraining,2,509,86,328,34,294,93,45,90,28,62,10
20-08-2021,GrayPanthers,3,340,251,77,37,40,64,26,38,32,6,1
20-08-2021,GrayPanthers,2,302,245,134,56,78,79,78,4,1,3,0
20-08-2021,BitterLaser,3,769,307,178,31,147,91,1,19,7,12,1
20-08-2021,CelestialInterface,3,610,411,275,8,267,83,31,39,21,18,1
20-08-2021,Mustangs,1,405,74,11,9,2,68,1,10,6,4,0
20-08-2021,ImpactTraining,2,880,660,305,115,190,57,15,44,13,31,1
20-08-2021,Quicksilver,3,645,557,11,7,4,62,35,3,2,1,0
20-08-2021,Mustangs,1,355,147,344,75,269,83,18,43,0,43,2
20-08-2021,ImpactTraining,2,881,342,732,284,448,55,14,33,12,21,2
20-08-2022,ImpactTraining,2,585,274,513,278,235,79,76,15,4,11,1
20-08-2022,CelestialInterface,1,856,355,456,138,318,57,15,47,32,15,0
20-08-2022,ImpactTraining,3,430,204,218,42,176,82,80,36,1,35,2
20-08-2022,PrimeSeven,2,984,793,381,282,99,71,13,20,14,6,0
20-08-2022,ImpactTraining,1,699,537,68,12,56,61,14,31,20,11,1
20-08-2022,Honeycomb,2,516,392,133,126,7,57,18,14,9,5,1
20-08-2022,Discovery,2,839,426,19,8,11,86,6,81,9,72,1
20-08-2022,BitterLaser,2,637,620,587,526,61,74,71,56,50,6,1
20-08-2022,Quicksilver,2,872,832,293,75,218,73,60,71,18,53,9
20-08-2023,Honeycomb,1,790,8,422,118,304,89,52,77,56,21,9
20-08-2023,Aurora,1,335,321,20,18,2,90,48,26,10,16,1
20-08-2023,GrayPanthers,3,423,217,258,10,248,52,0,37,23,14,2
20-08-2023,Quicksilver,3,990,145,406,147,259,51,29,43,33,10,1
20-09-2021,Mustangs,2,333,245,320,112,208,65,42,19,17,2,0
20-09-2021,BitterLaser,1,882,560,790,37,753,60,45,41,34,7,5
20-09-2021,PrimeSeven,2,244,27,103,22,81,55,2,34,24,10,2
20-09-2021,GrayPanthers,1,864,295,635,68,567,59,49,18,12,6,0
20-09-2021,PrimeSeven,3,336,192,135,68,67,81,78,5,3,2,0
20-09-2021,Quicksilver,2,248,173,44,42,2,91,83,32,18,14,0
20-09-2021,GrayPanthers,1,612,370,276,20,256,81,36,78,46,32,3
20-09-2021,PrimeSeven,3,377,169,60,43,17,97,37,43,1,42,5
20-09-2021,ImpactTraining,1,356,279,14,5,9,62,51,7,0,7,0
20-09-2021,Mustangs,3,872,749,426,328,98,99,31,3,2,1,0
20-09-2022,Quicksilver,3,624,539,310,273,37,78,75,26,3,23,1
20-09-2022,ImpactTraining,2,940,925,558,201,357,85,83,37,10,27,0
20-09-2022,PrimeSeven,3,697,650,266,149,117,81,29,11,10,1,0
20-09-2022,Discovery,1,904,870,681,436,245,69,40,24,7,17,1
20-09-2022,ImpactTraining,1,102,67,66,29,37,94,21,71,68,3,1
20-09-2022,Aurora,2,219,73,56,21,35,51,39,43,12,31,1
20-09-2022,Mustangs,3,720,705,651,108,543,73,21,60,10,50,4
20-09-2022,Quicksilver,2,594,429,540,91,449,92,18,77,6,71,4
20-09-2022,BitterLaser,1,311,212,198,112,86,56,7,0,0,0,0
20-09-2023,ImpactTraining,2,238,138,219,25,194,95,78,49,7,42,2
20-09-2023,Aurora,3,133,69,34,21,13,90,52,76,1,75,0
20-09-2023,Aurora,2,206,76,193,40,153,97,92,84,37,47,10
20-09-2023,GrayPanthers,1,838,2,508,272,236,79,29,40,37,3,0
20-09-2023,PrimeSeven,2,408,260,53,43,10,82,81,25,0,25,0
20-09-2023,CelestialInterface,1,175,123,64,40,24,88,20,75,48,27,5
20-09-2023,CelestialInterface,2,157,121,136,56,80,63,21,45,5,40,3
20-10-2021,Honeycomb,3,301,194,158,44,114,51,30,46,2,44,5
20-10-2021,GrayPanthers,3,479,16,224,172,52,70,44,30,29,1,2
20-10-2021,CelestialInterface,1,647,577,424,193,231,68,21,54,48,6,3
20-10-2021,Mustangs,3,763,128,194,88,106,89,1,15,1,14,0
20-10-2021,Quicksilver,3,371,98,222,177,45,90,85,33,16,17,1
20-10-2021,ImpactTraining,1,959,665,341,284,57,88,2,47,6,41,1
20-10-2021,ImpactTraining,3,136,90,118,41,77,89,77,27,2,25,3
20-10-2021,Honeycomb,3,632,29,98,77,21,55,6,8,3,5,0
20-10-2021,PrimeSeven,3,291,256,109,73,36,65,35,4,2,2,0
20-10-2022,CelestialInterface,3,560,109,402,88,314,51,13,30,9,21,0
20-10-2022,Discovery,1,247,171,59,48,11,72,18,26,16,10,2
20-10-2022,CelestialInterface,1,829,448,570,335,235,62,36,14,9,5,1
20-10-2022,Discovery,2,752,363,555,127,428,96,51,45,20,25,1
20-10-2022,ImpactTraining,3,663,121,74,69,5,66,22,48,40,8,3
20-10-2022,Quicksilver,1,711,490,176,49,127,60,30,30,7,23,0
20-10-2022,GrayPanthers,1,832,80,808,54,754,91,21,25,17,8,0
20-10-2022,PrimeSeven,3,705,530,13,7,6,85,2,72,20,52,3
20-10-2022,BitterLaser,1,914,878,670,109,561,50,18,18,9,9,0
20-10-2022,GrayPanthers,3,788,637,182,20,162,98,15,83,4,79,5
20-10-2022,ImpactTraining,3,754,706,6,5,1,77,45,0,0,0,0
20-10-2022,Quicksilver,3,252,169,221,213,8,66,1,45,21,24,0
20-10-2023,ImpactTraining,1,759,680,235,208,27,76,20,36,30,6,4
20-10-2023,Discovery,2,119,3,26,17,9,90,43,40,34,6,0
20-10-2023,PrimeSeven,2,356,309,243,133,110,87,34,0,0,0,0
20-10-2023,Mustangs,3,296,2,163,117,46,56,13,52,19,33,1
20-10-2023,BitterLaser,1,213,144,118,103,15,82,2,63,52,11,3
20-10-2023,Honeycomb,2,385,246,239,75,164,94,24,67,7,60,2
20-10-2023,Discovery,3,286,282,48,44,4,86,43,45,44,1,1
20-10-2023,BitterLaser,1,739,627,405,304,101,76,75,42,16,26,5
20-10-2023,Discovery,1,280,5,160,66,94,76,32,9,3,6,0
20-10-2023,Aurora,3,848,322,663,533,130,100,25,95,41,54,12
20-11-2021,CelestialInterface,1,272,217,238,214,24,65,9,53,25,28,3
20-11-2021,PrimeSeven,1,779,685,396,7,389,78,37,52,27,25,0
20-11-2021,PrimeSeven,2,728,537,317,217,100,68,61,49,2,47,4
20-11-2021,GrayPanthers,1,352,75,62,55,7,84,54,28,3,25,3
20-11-2021,BitterLaser,2,700,363,433,344,89,86,83,54,26,28,1
20-11-2021,Honeycomb,3,885,845,49,30,19,64,24,17,16,1,0
20-11-2021,ImpactTraining,1,509,270,143,64,79,96,92,32,26,6,2
20-11-2022,GrayPanthers,3,907,203,610,115,495,72,0,40,37,3,0
20-11-2022,Aurora,1,631,403,515,218,297,88,20,65,30,35,5
20-11-2022,Aurora,1,969,253,806,757,49,67,32,19,7,12,1
20-11-2022,Aurora,1,664,413,477,165,312,89,25,61,36,25,3
20-11-2022,Honeycomb,2,686,27,649,391,258,61,30,1,0,1,0
20-11-2022,Aurora,2,656,646,186,44,142,55,36,35,7,28,1
20-11-2022,BitterLaser,1,305,137,212,142,70,52,45,42,38,4,0
20-11-2023,BitterLaser,2,546,95,278,115,163,76,72,40,4,36,1
20-11-2023,Honeycomb,1,670,231,448,321,127,75,33,56,34,22,3
20-11-2023,ImpactTraining,3,724,317,336,101,235,74,24,61,55,6,0
20-11-2023,Discovery,1,668,208,656,134,522,83,81,42,16,26,5
20-11-2023,Discovery,1,257,115,146,108,38,54,13,48,25,23,4
20-11-2023,Discovery,2,952,742,749,514,235,58,48,7,1,6,0
20-11-2023,Discovery,2,485,452,265,24,241,81,45,34,27,7,1
20-12-2021,BitterLaser,2,205,159,34,11,23,100,71,89,10,79,6
20-12-2021,Mustangs,3,863,273,165,74,91,100,14,83,18,65,8
20-12-2021,Mustangs,1,452,443,369,38,331,76,25,2,0,2,0
20-12-2021,Discovery,3,282,231,38,12,26,55,14,10,7,3,0
20-12-2021,GrayPanthers,3,137,55,135,33,102,93,74,74,16,58,0
20-12-2021,Discovery,1,867,580,709,465,244,84,72,14,10,4,1
20-12-2021,ImpactTraining,3,730,501,499,305,194,79,17,1,0,1,0
20-12-2021,ImpactTraining,3,892,706,533,44,489,74,31,33,26,7,2
20-12-2021,Aurora,3,356,41,96,89,7,70,0,36,23,13,4
20-12-2021,GrayPanthers,3,598,138,93,10,83,62,54,39,34,5,4
20-12-2021,BitterLaser,2,559,91,6,0,6,88,30,79,10,69,10
20-12-2022,CelestialInterface,1,299,66,192,174,18,63,57,19,13,6,1
20-12-2022,BitterLaser,3,917,411,586,134,452,57,19,37,31,6,2
20-12-2022,Mustangs,2,677,460,550,444,106,82,29,70,3,67,4
20-12-2022,Quicksilver,1,220,209,196,91,105,85,5,19,8,11,1
20-12-2022,Aurora,1,453,381,432,237,195,73,47,61,50,11,7
20-12-2022,Discovery,2,686,22,66,61,5,68,17,7,1,6,0
20-12-2022,ImpactTraining,2,220,99,91,84,7,72,48,42,37,5,0
20-12-2022,Mustangs,2,202,185,90,5,85,60,4,56,30,26,2
20-12-2022,Discovery,2,891,350,106,31,75,54,25,9,4,5,0
20-12-2022,PrimeSeven,2,373,324,207,163,44,66,34,39,2,37,4
20-12-2023,GrayPanthers,2,734,652,135,132,3,92,82,40,39,1,1
20-12-2023,Honeycomb,3,511,72,494,360,134,57,43,13,8,5,0
20-12-2023,Discovery,2,836,671,398,349,49,62,49,25,15,10,1
20-12-2023,Quicksilver,2,377,346,264,61,203,82,57,12,3,9,0
20-12-2023,GrayPanthers,3,353,163,147,119,28,82,25,44,13,31,0
20-12-2023,GrayPanthers,2,639,275,496,241,255,76,18,69,43,26,9
20-12-2023,CelestialInterface,2,498,293,261,112,149,69,5,12,9,3,0
20-12-2023,PrimeSeven,1,786,605,394,284,110,88,83,18,15,3,1
20-12-2023,PrimeSeven,3,714,459,622,572,50,94,71,82,3,79,4
20-12-2023,BitterLaser,2,217,188,166,111,55,95,39,89,19,70,10
20-12-2023,CelestialInterface,1,453,81,149,112,37,57,55,4,3,1,0
20-12-2023,ImpactTraining,2,769,759,540,489,51,50,33,4,1,3,0
21-01-2021,PrimeSeven,1,735,77,691,579,112,88,11,2,0,2,0
21-01-2021,Quicksilver,3,676,445,612,254,358,52,39,28,27,1,0
21-01-2021,Aurora,1,530,18,437,287,150,51,27,38,17,21,1
21-01-2021,PrimeSeven,1,727,575,131,81,50,77,68,49,19,30,6
21-01-2022,ImpactTraining,3,389,292,236,165,71,76,57,3,1,2,0
21-01-2022,Aurora,3,155,52,66,48,18,79,5,52,41,11,1
21-01-2022,ImpactTraining,2,295,31,60,7,53,51,27,28,26,2,2
21-01-2022,Honeycomb,2,826,24,100,32,68,83,56,50,37,13,5
21-01-2022,Quicksilver,1,903,453,735,658,77,69,62,29,5,24,0
21-01-2022,Honeycomb,2,337,326,75,58,17,51,42,27,15,12,3
21-01-2022,Honeycomb,3,726,717,606,583,23,57,55,54,18,36,4
21-01-2022,Mustangs,3,846,120,540,151,389,100,22,60,10,50,4
21-01-2023,Discovery,1,446,242,217,24,193,91,64,44,4,40,0
21-01-2023,GrayPanthers,3,995,279,638,206,432,85,20,30,3,27,3
21-01-2023,CelestialInterface,3,438,184,271,61,210,80,55,35,19,16,0
21-01-2023,Honeycomb,1,751,103,614,602,12,69,33,43,35,8,1
21-01-2023,Honeycomb,3,433,226,251,204,47,85,39,11,4,7,0
21-01-2023,CelestialInterface,1,283,40,82,63,19,90,57,70,58,12,8
21-01-2023,GrayPanthers,2,361,277,183,176,7,95,30,3,1,2,0
21-01-2023,ImpactTraining,2,673,428,550,398,152,97,69,12,11,1,0
21-02-2021,Aurora,3,312,191,229,61,168,71,25,67,47,20,4
21-02-2021,ImpactTraining,2,860,705,286,106,180,56,33,23,11,12,0
21-02-2021,Honeycomb,3,800,226,524,80,444,81,36,50,25,25,6
21-02-2021,Discovery,3,600,93,410,370,40,86,0,79,36,43,7
21-02-2021,Mustangs,2,424,19,109,33,76,84,49,6,2,4,0
21-02-2021,GrayPanthers,2,405,218,40,34,6,74,61,2,1,1,0
21-02-2021,GrayPanthers,3,779,24,214,90,124,85,3,49,22,27,4
21-02-2021,Aurora,2,845,573,739,726,13,61,59,15,7,8,0
21-02-2022,Discovery,3,746,504,159,126,33,74,30,62,34,28,3
21-02-2022,Discovery,3,806,190,724,670,54,82,11,66,45,21,5
21-02-2022,Honeycomb,1,553,309,383,324,59,100,18,24,2,22,1
21-02-2022,PrimeSeven,3,779,318,762,721,41,51,41,13,0,13,0
21-02-2022,Aurora,3,521,223,199,136,63,90,23,71,20,51,6
21-02-2022,Discovery,3,981,947,642,204,438,64,17,44,12,32,4
21-02-2022,PrimeSeven,2,719,345,680,313,367,86,58,37,33,4,2
21-02-2023,GrayPanthers,3,412,41,242,141,101,87,53,74,49,25,9
21-02-2023,Aurora,1,119,114,72,54,18,66,56,18,2,16,0
21-02-2023,PrimeSeven,2,838,454,743,627,116,92,75,67,13,54,0
21-02-2023,Discovery,2,443,365,119,73,46,96,43,60,44,16,3
21-02-2023,BitterLaser,1,359,124,4,1,3,57,49,5,0,5,0
21-02-2023,Quicksilver,2,680,116,202,80,122,54,2,11,3,8,0
21-02-2023,BitterLaser,3,741,738,621,79,542,69,61,9,6,3,0
21-02-2023,Aurora,2,638,352,603,256,347,62,47,15,2,13,1
21-02-2023,PrimeSeven,2,740,425,666,92,574,74,41,52,25,27,1
21-02-2023,Discovery,2,657,324,620,168,452,87,42,17,13,4,0
21-02-2023,Honeycomb,2,402,351,201,157,44,70,63,9,6,3,0
21-02-2023,Discovery,1,609,567,557,534,23,91,38,40,5,35,0
21-02-2023,Honeycomb,2,718,567,73,42,31,76,73,21,1,20,0
21-03-2021,PrimeSeven,2,908,704,15,8,7,74,5,56,17,39,2
21-03-2021,Mustangs,2,481,62,46,26,20,71,68,4,0,4,0
21-03-2021,CelestialInterface,2,173,57,81,77,4,98,4,80,31,49,11
21-03-2021,PrimeSeven,2,903,444,43,9,34,50,35,6,5,1,0
21-03-2021,Aurora,3,421,297,56,3,53,53,44,41,20,21,1
21-03-2021,PrimeSeven,3,240,51,159,121,38,58,15,27,1,26,2
21-03-2021,GrayPanthers,3,796,680,237,165,72,91,72,84,63,21,7
21-03-2021,ImpactTraining,3,168,161,143,91,52,92,89,76,53,23,2
21-03-2021,BitterLaser,2,731,490,259,164,95,54,38,46,31,15,0
21-03-2021,ImpactTraining,1,919,631,541,475,66,69,10,36,31,5,1
21-03-2021,GrayPanthers,1,976,33,364,32,332,57,15,52,5,47,2
21-03-2022,Mustangs,3,657,131,300,232,68,94,24,23,20,3,0
21-03-2022,CelestialInterface,1,277,237,207,127,80,54,33,10,0,10,0
21-03-2022,Aurora,2,810,476,109,46,63,64,23,27,21,6,3
21-03-2022,Aurora,1,352,235,243,89,154,82,50,24,6,18,0
21-03-2022,Quicksilver,1,256,88,202,69,133,82,12,11,10,1,0
21-03-2022,ImpactTraining,3,458,79,393,262,131,50,27,37,15,22,1
21-03-2022,PrimeSeven,3,457,275,348,48,300,86,84,74,66,8,3
21-03-2023,CelestialInterface,3,853,317,438,403,35,67,24,30,2,28,1
21-03-2023,CelestialInterface,1,403,87,286,276,10,84,66,40,14,26,2
21-03-2023,BitterLaser,1,426,317,364,67,297,53,3,22,20,2,1
21-03-2023,Mustangs,3,712,378,552,301,251,75,37,71,12,59,2
21-03-2023,Discovery,2,772,186,448,192,256,66,21,6,1,5,0
21-03-2023,Aurora,1,242,1,213,70,143,82,59,54,19,35,7
21-03-2023,Quicksilver,1,389,363,352,229,123,78,23,28,26,2,1
21-03-2023,Aurora,2,326,258,42,39,3,93,32,52,6,46,3
21-03-2023,ImpactTraining,2,315,274,212,17,195,57,52,13,6,7,0
21-03-2023,Discovery,1,769,81,389,91,298,91,53,9,5,4,0
21-03-2023,Quicksilver,1,134,62,115,114,1,74,71,58,8,50,6
21-03-2023,Aurora,3,808,801,50,15,35,82,18,8,2,6,0
21-03-2023,CelestialInterface,3,647,9,293,262,31,70,51,41,10,31,2
21-04-2021,Mustangs,3,737,590,253,211,42,63,62,2,1,1,0
21-04-2021,Aurora,1,833,486,676,166,510,52,7,46,11,35,0
21-04-2021,Discovery,1,883,270,602,154,448,80,31,43,30,13,1
21-04-2021,CelestialInterface,1,112,65,2,0,2,58,5,10,7,3,0
21-04-2021,GrayPanthers,3,445,128,66,49,17,80,23,10,5,5,0
21-04-2021,GrayPanthers,3,466,121,192,60,132,86,7,77,8,69,1
21-04-2021,Discovery,3,549,239,65,32,33,60,1,28,18,10,3
21-04-2021,Discovery,2,823,627,270,144,126,63,14,32,24,8,3
21-04-2021,GrayPanthers,3,203,193,186,91,95,97,52,18,3,15,0
21-04-2021,Mustangs,1,747,270,171,131,40,77,17,53,13,40,5
21-04-2021,Quicksilver,3,808,677,719,697,22,63,18,44,1,43,2
21-04-2021,Aurora,1,577,205,84,43,41,96,10,41,6,35,2
21-04-2022,CelestialInterface,3,428,220,231,125,106,52,23,23,22,1,0
21-04-2022,GrayPanthers,1,433,191,372,307,65,99,67,87,78,9,6
21-04-2022,Aurora,1,841,115,258,119,139,87,13,7,2,5,0
21-04-2022,PrimeSeven,3,168,93,99,51,48,77,20,31,6,25,3
21-04-2022,Quicksilver,3,881,630,397,329,68,70,20,1,0,1,0
21-04-2023,Honeycomb,1,980,856,371,84,287,96,53,73,45,28,1
21-04-2023,ImpactTraining,2,299,9,128,3,125,71,51,64,12,52,5
21-04-2023,CelestialInterface,2,106,35,52,46,6,65,44,28,0,28,0
21-04-2023,Mustangs,2,724,712,593,156,437,71,39,43,33,10,3
21-04-2023,ImpactTraining,3,537,527,228,137,91,76,56,5,0,5,0
21-04-2023,Honeycomb,2,560,490,151,59,92,75,52,43,29,14,5
21-04-2023,ImpactTraining,3,376,154,105,54,51,100,29,24,7,17,2
21-05-2021,ImpactTraining,3,815,308,431,400,31,54,22,12,2,10,0
21-05-2021,Quicksilver,3,328,208,146,87,59,68,6,18,17,1,1
21-05-2021,Discovery,1,794,752,238,230,8,51,29,20,16,4,1
21-05-2021,ImpactTraining,3,256,56,41,16,25,86,52,60,21,39,1
21-05-2021,Honeycomb,1,997,430,111,26,85,80,4,10,6,4,0
21-05-2021,ImpactTraining,1,144,120,61,35,26,66,37,44,41,3,1
21-05-2021,Mustangs,1,473,288,417,346,71,60,43,30,14,16,2
21-05-2021,PrimeSeven,3,741,246,482,242,240,71,19,51,37,14,2
21-05-2021,GrayPanthers,2,602,596,35,6,29,88,45,55,52,3,0
21-05-2021,Aurora,2,963,344,202,183,19,68,6,40,13,27,4
21-05-2021,Quicksilver,2,125,93,15,12,3,77,2,12,1,11,0
21-05-2021,PrimeSeven,1,162,50,15,13,2,65,61,46,18,28,2
21-05-2022,Discovery,3,655,510,328,324,4,71,0,69,29,40,0
21-05-2022,Aurora,2,207,194,42,20,22,58,44,5,4,1,0
21-05-2022,CelestialInterface,2,354,241,167,65,102,94,19,71,45,26,9
21-05-2022,Discovery,2,253,226,172,100,72,91,90,11,3,8,0
21-05-2022,Honeycomb,2,989,874,675,357,318,99,23,29,0,29,2
21-05-2023,Aurora,3,420,286,2,1,1,71,3,24,18,6,2
21-05-2023,Honeycomb,1,766,537,421,283,138,63,38,23,14,9,1
21-05-2023,Mustangs,3,771,336,62,22,40,83,50,70,1,69,8
21-05-2023,ImpactTraining,1,852,14,357,267,90,78,30,10,5,5,0
21-05-2023,Discovery,3,973,822,812,256,556,70,53,44,2,42,1
21-05-2023,Honeycomb,3,263,231,174,168,6,65,9,46,34,12,3
21-05-2023,PrimeSeven,2,177,31,11,5,6,70,66,38,20,18,1
21-05-2023,Honeycomb,1,245,192,78,30,48,61,15,17,4,13,1
21-05-2023,Quicksilver,1,431,103,407,338,69,86,13,1,0,1,0
21-05-2023,GrayPanthers,3,477,449,315,202,113,100,74,94,44,50,8
21-05-2023,GrayPanthers,3,765,454,460,188,272,84,10,11,3,8,0
21-05-2023,Quicksilver,2,428,369,92,32,60,84,29,60,58,2,2
21-05-2023,BitterLaser,1,406,23,42,21,21,96,82,81,75,6,6
21-05-2023,Discovery,1,814,644,564,510,54,52,47,36,29,7,1
21-06-2021,Quicksilver,1,396,139,264,35,229,76,24,46,1,45,4
21-06-2021,PrimeSeven,3,293,281,67,65,2,90,30,9,8,1,0
21-06-2021,Aurora,1,730,603,690,385,305,94,67,1,0,1,0
21-06-2021,Honeycomb,1,916,395,907,601,306,76,28,46,41,5,3
21-06-2021,Aurora,1,703,394,575,69,506,84,28,68,60,8,9
21-06-2021,Quicksilver,1,935,838,595,203,392,92,20,36,24,12,0
21-06-2021,GrayPanthers,1,285,54,161,15,146,70,64,37,14,23,0
21-06-2021,Honeycomb,2,246,26,108,55,53,91,60,31,14,17,3
21-06-2021,CelestialInterface,2,292,132,79,73,6,82,6,57,11,46,6
21-06-2022,Honeycomb,2,450,74,418,301,117,97,87,11,1,10,0
21-06-2022,Quicksilver,1,645,379,575,349,226,80,63,0,0,0,0
21-06-2022,CelestialInterface,1,651,610,270,21,249,86,75,37,2,35,3
21-06-2022,Discovery,1,634,102,377,275,102,86,67,85,40,45,1
21-06-2022,CelestialInterface,1,965,485,710,127,583,88,80,1,0,1,0
21-06-2023,CelestialInterface,3,235,134,25,14,11,50,21,34,26,8,3
21-06-2023,CelestialInterface,3,450,71,287,77,210,56,19,1,0,1,0
21-06-2023,Discovery,1,301,195,158,85,73,78,67,65,25,40,2
21-06-2023,PrimeSeven,1,618,421,562,495,67,73,17,35,19,16,0
21-06-2023,CelestialInterface,2,612,269,255,38,217,74,37,20,19,1,2
21-06-2023,BitterLaser,1,324,42,255,171,84,53,41,6,5,1,0
21-06-2023,PrimeSeven,3,715,290,413,225,188,52,38,11,1,10,0
21-06-2023,CelestialInterface,3,958,144,523,245,278,89,78,51,41,10,4
21-06-2023,ImpactTraining,2,797,42,44,17,27,71,29,39,35,4,3
21-06-2023,CelestialInterface,1,283,279,151,18,133,65,25,34,25,9,3
21-06-2023,BitterLaser,1,644,561,336,102,234,66,52,35,1,34,2
21-06-2023,Aurora,2,367,340,356,305,51,62,11,26,22,4,1
21-06-2023,Aurora,2,685,544,46,33,13,59,53,28,0,28,0
21-06-2023,Discovery,2,327,136,248,39,209,64,61,47,11,36,2
21-06-2023,Discovery,2,497,426,88,77,11,77,13,54,46,8,2
21-06-2023,PrimeSeven,2,337,141,159,31,128,81,26,69,58,11,2
21-07-2021,CelestialInterface,1,134,22,121,81,40,61,59,26,16,10,2
21-07-2021,Quicksilver,2,263,15,168,146,22,84,65,10,0,10,0
21-07-2021,Quicksilver,3,574,2,334,125,209,73,64,7,0,7,0
21-07-2021,PrimeSeven,1,287,242,283,158,125,54,39,29,3,26,0
21-07-2021,GrayPanthers,3,282,195,38,26,12,72,57,16,2,14,1
21-07-2021,Quicksilver,3,762,120,308,71,237,86,44,37,23,14,1
21-07-2021,Mustangs,3,571,441,411,282,129,66,22,7,0,7,0
21-07-2021,ImpactTraining,1,839,673,713,385,328,90,30,83,0,83,7
21-07-2021,Aurora,3,873,542,293,47,246,72,6,10,2,8,0
21-07-2021,CelestialInterface,1,781,550,33,2,31,82,48,12,11,1,0
21-07-2022,PrimeSeven,1,522,302,371,363,8,72,65,20,12,8,2
21-07-2022,CelestialInterface,3,838,420,576,500,76,58,0,42,28,14,3
21-07-2022,Mustangs,1,567,167,480,216,264,53,50,39,10,29,0
21-07-2022,Aurora,2,226,103,175,141,34,56,12,38,31,7,1
21-07-2022,Quicksilver,3,871,180,644,328,316,50,0,8,0,8,0
21-07-2022,BitterLaser,3,876,485,604,196,408,81,61,13,5,8,0
21-07-2022,Aurora,2,766,439,48,41,7,85,42,71,14,57,6
21-07-2022,Quicksilver,2,373,125,292,264,28,98,19,68,37,31,9
21-07-2022,BitterLaser,1,607,555,255,140,115,80,15,56,30,26,6
21-07-2022,Honeycomb,2,276,226,154,120,34,63,5,25,10,15,2
21-07-2022,Aurora,2,736,168,259,2,257,65,60,6,0,6,0
21-07-2023,Aurora,1,147,99,3,2,1,58,47,29,2,27,1
21-07-2023,PrimeSeven,2,940,416,48,30,18,73,64,56,50,6,2
21-07-2023,ImpactTraining,3,611,203,14,3,11,75,62,39,11,28,3
21-07-2023,ImpactTraining,1,417,61,415,267,148,58,27,37,33,4,4
21-07-2023,ImpactTraining,2,496,127,77,69,8,73,42,48,8,40,0
21-07-2023,Honeycomb,1,416,218,12,7,5,88,58,48,38,10,3
21-07-2023,Quicksilver,1,539,161,46,12,34,67,9,19,18,1,0
21-07-2023,ImpactTraining,3,404,63,169,136,33,59,17,21,11,10,1
21-07-2023,Discovery,2,847,824,265,24,241,74,61,26,2,24,0
21-08-2021,Aurora,1,709,291,104,68,36,74,60,73,16,57,3
21-08-2021,Discovery,2,883,774,608,30,578,73,42,53,5,48,3
21-08-2021,PrimeSeven,1,246,147,161,123,38,88,20,50,26,24,3
21-08-2021,Discovery,1,205,52,158,64,94,76,75,70,16,54,1
21-08-2021,Discovery,2,780,383,414,361,53,91,77,26,20,6,2
21-08-2021,PrimeSeven,2,613,188,357,214,143,70,45,7,4,3,0
21-08-2022,BitterLaser,2,514,79,77,76,1,76,18,44,38,6,2
21-08-2022,Aurora,2,109,60,106,42,64,82,9,66,29,37,8
21-08-2022,Quicksilver,2,604,321,206,162,44,78,54,55,24,31,1
21-08-2022,Honeycomb,2,688,323,552,292,260,77,19,69,27,42,7
21-08-2022,GrayPanthers,1,745,425,223,43,180,62,30,24,20,4,0
21-08-2022,ImpactTraining,1,826,324,439,194,245,83,33,8,3,5,0
21-08-2022,GrayPanthers,3,313,231,24,4,20,56,18,19,4,15,0
21-08-2022,BitterLaser,2,518,342,8,4,4,89,62,15,7,8,0
21-08-2023,Honeycomb,1,437,53,52,25,27,57,44,53,14,39,3
21-08-2023,PrimeSeven,3,596,230,251,157,94,62,3,5,3,2,0
21-08-2023,Discovery,1,236,5,111,25,86,94,3,12,0,12,0
21-08-2023,Mustangs,1,845,332,132,65,67,54,0,3,2,1,0
21-08-2023,Discovery,3,456,285,229,2,227,63,28,48,13,35,2
21-08-2023,Aurora,3,879,595,9,7,2,63,36,55,0,55,6
21-08-2023,PrimeSeven,3,998,56,542,52,490,55,2,41,38,3,1
21-09-2021,Discovery,3,595,71,415,100,315,78,26,63,29,34,4
21-09-2021,BitterLaser,2,905,401,32,18,14,52,21,18,0,18,0
21-09-2021,Quicksilver,2,824,354,499,481,18,97,55,52,32,20,6
21-09-2021,ImpactTraining,1,281,173,187,26,161,52,27,22,3,19,2
21-09-2021,Quicksilver,2,176,27,157,141,16,88,63,54,41,13,5
21-09-2021,Aurora,3,849,717,838,503,335,63,37,23,6,17,0
21-09-2021,BitterLaser,1,579,319,41,3,38,64,2,49,33,16,6
21-09-2021,PrimeSeven,1,614,34,60,26,34,72,51,15,1,14,1
21-09-2021,Honeycomb,2,767,479,133,106,27,55,17,54,3,51,4
21-09-2021,PrimeSeven,2,933,252,111,65,46,100,4,43,5,38,0
21-09-2021,ImpactTraining,3,554,340,34,15,19,89,10,35,9,26,2
21-09-2021,Honeycomb,2,172,63,80,14,66,56,2,51,28,23,4
21-09-2021,Aurora,1,787,388,588,372,216,72,6,59,21,38,2
21-09-2021,Aurora,3,328,286,269,194,75,100,20,9,6,3,0
21-09-2021,ImpactTraining,3,271,85,46,9,37,51,6,18,17,1,0
21-09-2022,Discovery,1,145,53,107,20,87,74,9,63,43,20,4
21-09-2022,Discovery,1,333,141,295,11,284,90,27,88,68,20,4
21-09-2022,Quicksilver,3,179,91,126,100,26,53,8,6,1,5,0
21-09-2022,Honeycomb,1,393,310,2,0,2,57,30,19,13,6,0
21-09-2023,GrayPanthers,3,300,191,98,57,41,84,56,42,14,28,5
21-09-2023,Honeycomb,3,678,571,267,260,7,100,59,92,73,19,2
21-09-2023,BitterLaser,2,684,143,264,163,101,67,66,59,40,19,6
21-09-2023,Mustangs,1,958,694,88,41,47,59,6,25,2,23,0
21-09-2023,GrayPanthers,1,300,61,163,59,104,81,41,67,11,56,3
21-09-2023,ImpactTraining,1,369,62,233,145,88,60,20,59,57,2,6
21-09-2023,BitterLaser,2,854,18,460,29,431,51,20,44,41,3,4
21-09-2023,GrayPanthers,3,335,294,232,82,150,54,5,4,0,4,0
21-10-2021,Quicksilver,3,928,160,727,323,404,79,12,32,8,24,2
21-10-2021,Discovery,1,408,145,41,35,6,73,56,53,42,11,5
21-10-2021,Aurora,2,274,163,14,8,6,80,61,72,58,14,8
21-10-2022,Discovery,3,636,74,561,559,2,85,7,30,15,15,1
21-10-2022,PrimeSeven,3,662,44,211,147,64,57,55,2,1,1,0
21-10-2022,GrayPanthers,2,193,184,178,149,29,74,25,58,23,35,0
21-10-2022,ImpactTraining,1,507,370,112,6,106,81,6,28,14,14,3
21-10-2022,Aurora,2,147,125,85,37,48,71,5,31,29,2,3
21-10-2022,PrimeSeven,3,824,583,121,32,89,97,60,6,0,6,0
21-10-2022,PrimeSeven,2,413,317,11,10,1,63,30,0,0,0,0
21-10-2022,ImpactTraining,1,105,58,22,1,21,90,68,33,29,4,0
21-10-2022,PrimeSeven,2,780,140,390,49,341,68,14,19,10,9,1
21-10-2023,GrayPanthers,2,587,215,521,316,205,74,18,73,55,18,9
21-10-2023,GrayPanthers,3,411,231,396,40,356,88,38,22,10,12,2
21-10-2023,Quicksilver,1,597,194,415,73,342,98,86,83,34,49,1
21-10-2023,Honeycomb,3,681,303,428,269,159,76,29,55,51,4,2
21-10-2023,BitterLaser,3,479,313,59,24,35,79,6,14,13,1,0
21-10-2023,PrimeSeven,1,712,353,216,7,209,60,17,31,15,16,2
21-10-2023,Mustangs,2,170,140,100,59,41,63,38,32,2,30,0
21-10-2023,Discovery,3,961,388,446,196,250,76,15,18,16,2,0
21-11-2021,CelestialInterface,1,446,191,322,131,191,90,22,53,39,14,4
21-11-2021,Discovery,1,780,70,104,14,90,58,48,32,4,28,3
21-11-2021,GrayPanthers,2,757,594,509,195,314,73,46,47,27,20,5
21-11-2021,Discovery,3,210,25,83,37,46,89,45,29,17,12,3
21-11-2021,Discovery,2,822,90,193,112,81,67,65,0,0,0,0
21-11-2022,GrayPanthers,1,694,179,403,59,344,75,68,13,7,6,0
21-11-2022,BitterLaser,2,882,330,487,134,353,58,17,6,5,1,0
21-11-2022,Discovery,2,643,107,397,46,351,87,16,10,4,6,0
21-11-2022,Aurora,2,115,41,95,72,23,67,24,53,8,45,6
21-11-2022,BitterLaser,2,363,238,334,238,96,91,56,44,11,33,0
21-11-2022,Aurora,2,675,406,463,61,402,72,23,25,24,1,0
21-11-2022,ImpactTraining,3,253,88,220,166,54,100,55,82,58,24,6
21-11-2022,GrayPanthers,1,808,500,317,145,172,65,57,64,14,50,1
21-11-2022,PrimeSeven,2,962,957,735,613,122,75,50,28,12,16,0
21-11-2023,ImpactTraining,1,701,245,371,259,112,65,28,36,28,8,3
21-11-2023,Discovery,3,478,382,38,20,18,70,52,16,6,10,1
21-11-2023,Mustangs,2,670,149,394,19,375,85,35,38,24,14,3
21-11-2023,Honeycomb,3,398,187,391,114,277,79,41,35,17,18,0
21-11-2023,GrayPanthers,1,830,414,343,338,5,93,30,83,69,14,4
21-11-2023,ImpactTraining,2,931,508,210,206,4,89,56,51,20,31,6
21-11-2023,GrayPanthers,3,258,161,12,11,1,69,6,58,44,14,4
21-11-2023,Mustangs,2,786,36,94,46,48,57,49,37,24,13,4
21-12-2021,BitterLaser,2,871,5,593,184,409,97,72,94,81,13,2
21-12-2021,BitterLaser,3,658,475,110,79,31,56,50,7,3,4,0
21-12-2021,Discovery,2,438,154,429,284,145,82,5,79,45,34,4
21-12-2021,CelestialInterface,1,137,129,110,93,17,87,10,18,12,6,1
21-12-2021,GrayPanthers,2,554,502,375,225,150,80,15,71,29,42,0
21-12-2021,CelestialInterface,2,397,122,121,27,94,65,10,20,4,16,2
21-12-2021,Quicksilver,3,959,299,135,67,68,80,36,5,0,5,0
21-12-2021,Discovery,2,817,745,424,124,300,68,45,1,0,1,0
21-12-2021,Discovery,1,145,42,84,23,61,79,32,3,1,2,0
21-12-2022,PrimeSeven,3,172,2,124,77,47,59,30,18,11,7,1
21-12-2022,CelestialInterface,2,223,0,28,14,14,94,51,61,8,53,3
21-12-2022,PrimeSeven,1,470,439,270,113,157,64,1,54,18,36,0
21-12-2022,Mustangs,3,590,310,442,407,35,57,40,20,1,19,2
21-12-2022,BitterLaser,1,384,250,355,215,140,70,48,43,41,2,3
21-12-2022,Honeycomb,2,940,716,576,121,455,53,33,20,11,9,2
21-12-2022,Aurora,3,153,144,146,28,118,71,39,34,2,32,0
21-12-2023,Mustangs,2,753,330,481,102,379,92,74,7,1,6,0
21-12-2023,Quicksilver,3,876,165,671,191,480,52,22,31,30,1,0
21-12-2023,GrayPanthers,1,159,67,122,1,121,74,15,6,0,6,0
21-12-2023,Aurora,2,520,382,410,210,200,54,48,38,29,9,3
21-12-2023,Mustangs,2,547,242,201,5,196,90,16,73,60,13,3
21-12-2023,CelestialInterface,2,400,268,344,23,321,73,16,20,2,18,0
22-01-2021,GrayPanthers,3,979,689,841,671,170,62,6,60,24,36,3
22-01-2021,Honeycomb,1,792,629,746,601,145,62,19,34,3,31,2
22-01-2021,Mustangs,2,670,230,591,298,293,51,24,32,4,28,1
22-01-2021,CelestialInterface,3,917,592,319,196,123,88,11,24,21,3,1
22-01-2021,CelestialInterface,2,932,246,791,411,380,54,30,28,21,7,0
22-01-2021,Mustangs,1,555,317,182,112,70,83,66,55,46,9,2
22-01-2021,Discovery,3,203,128,87,68,19,66,8,11,9,2,0
22-01-2022,BitterLaser,2,275,117,185,99,86,57,31,26,5,21,1
22-01-2022,Mustangs,1,694,168,31,8,23,87,43,47,22,25,5
22-01-2022,Aurora,2,923,37,604,129,475,88,27,8,5,3,0
22-01-2022,Aurora,2,503,169,94,27,67,51,24,33,16,17,0
22-01-2022,Quicksilver,3,847,655,111,58,53,53,0,16,12,4,0
22-01-2022,PrimeSeven,1,613,471,133,125,8,50,5,37,1,36,0
22-01-2022,Mustangs,2,728,534,366,8,358,65,38,44,31,13,0
22-01-2022,GrayPanthers,1,170,127,118,44,74,66,28,18,17,1,1
22-01-2022,CelestialInterface,2,738,239,244,220,24,51,8,38,8,30,3
22-01-2023,PrimeSeven,3,829,746,378,190,188,90,71,88,64,24,6
22-01-2023,ImpactTraining,1,392,72,274,227,47,56,27,21,19,2,1
22-01-2023,Quicksilver,2,460,417,187,138,49,92,45,50,14,36,5
22-01-2023,Quicksilver,3,129,3,63,13,50,76,16,37,2,35,3
22-01-2023,BitterLaser,3,287,166,239,4,235,65,58,49,5,44,0
22-01-2023,Mustangs,2,237,52,70,63,7,71,39,1,0,1,0
22-01-2023,Mustangs,1,320,61,165,71,94,80,37,35,23,12,0
22-01-2023,Mustangs,1,988,959,135,118,17,76,19,3,1,2,0
22-01-2023,PrimeSeven,1,315,218,152,151,1,79,66,21,11,10,0
22-02-2021,Honeycomb,2,424,150,126,3,123,56,49,51,49,2,1
22-02-2021,CelestialInterface,2,463,421,402,53,349,94,81,30,12,18,2
22-02-2021,PrimeSeven,1,901,526,884,285,599,78,75,15,12,3,0
22-02-2021,Discovery,3,881,338,289,173,116,63,43,31,14,17,2
22-02-2021,Quicksilver,1,687,585,615,360,255,94,5,59,16,43,1
22-02-2021,Quicksilver,2,302,79,116,112,4,95,88,48,6,42,0
22-02-2021,Discovery,2,835,726,546,318,228,76,67,51,31,20,3
22-02-2021,Mustangs,3,542,227,182,21,161,52,0,16,6,10,0
22-02-2021,Discovery,2,581,483,227,218,9,75,62,21,18,3,1
22-02-2022,Aurora,3,870,129,147,143,4,54,1,37,18,19,2
22-02-2022,PrimeSeven,3,559,323,182,181,1,94,12,86,1,85,4
22-02-2022,GrayPanthers,2,111,28,104,83,21,75,50,21,1,20,2
22-02-2022,CelestialInterface,2,465,10,126,110,16,77,10,67,61,6,4
22-02-2022,Mustangs,3,145,126,141,2,139,64,41,57,35,22,6
22-02-2022,Aurora,1,532,408,144,25,119,68,27,57,50,7,6
22-02-2022,ImpactTraining,3,228,209,110,13,97,78,55,66,25,41,4
22-02-2022,BitterLaser,2,250,152,116,92,24,74,59,31,5,26,0
22-02-2022,GrayPanthers,1,665,267,286,146,140,51,34,4,1,3,0
22-02-2022,CelestialInterface,2,949,939,186,61,125,82,5,28,17,11,3
22-02-2022,GrayPanthers,1,462,110,416,366,50,91,50,78,45,33,7
22-02-2022,GrayPanthers,1,878,722,128,63,65,50,6,11,7,4,0
22-02-2022,Aurora,1,760,23,728,168,560,91,50,5,3,2,0
22-02-2022,Discovery,3,443,196,28,20,8,63,37,59,44,15,3
22-02-2023,Aurora,3,419,201,161,12,149,80,51,44,39,5,1
22-02-2023,BitterLaser,1,200,75,152,58,94,83,17,11,3,8,0
22-02-2023,Aurora,1,958,118,819,651,168,88,54,31,29,2,0
22-02-2023,ImpactTraining,2,935,536,594,177,417,71,44,50,30,20,6
22-02-2023,GrayPanthers,1,160,82,30,3,27,50,0,46,6,40,1
22-02-2023,GrayPanthers,2,835,261,806,379,427,57,29,33,7,26,0
22-02-2023,GrayPanthers,2,994,272,989,229,760,73,46,68,66,2,2
22-03-2021,Quicksilver,3,779,382,85,42,43,72,16,28,5,23,2
22-03-2021,PrimeSeven,2,685,340,523,436,87,81,1,49,38,11,2
22-03-2021,Aurora,3,782,414,435,422,13,58,33,43,17,26,1
22-03-2021,Mustangs,1,710,646,625,302,323,98,92,97,58,39,8
22-03-2021,GrayPanthers,2,143,95,20,7,13,92,83,82,13,69,6
22-03-2021,Honeycomb,3,609,105,418,10,408,67,39,38,15,23,3
22-03-2021,Mustangs,3,632,626,78,39,39,77,69,36,23,13,4
22-03-2021,ImpactTraining,1,350,196,345,157,188,66,59,3,2,1,0
22-03-2021,Mustangs,2,328,320,218,181,37,52,32,31,22,9,2
22-03-2021,Quicksilver,3,769,177,713,547,166,80,2,62,6,56,6
22-03-2022,ImpactTraining,2,565,343,5,2,3,61,38,20,6,14,1
22-03-2022,CelestialInterface,2,117,69,107,14,93,91,47,55,31,24,1
22-03-2022,Mustangs,2,490,293,228,161,67,63,12,59,52,7,7
22-03-2022,PrimeSeven,3,980,869,252,118,134,65,33,40,27,13,4
22-03-2022,GrayPanthers,2,570,171,37,30,7,64,35,60,34,26,2
22-03-2022,Discovery,3,807,79,3,1,2,53,25,36,29,7,3
22-03-2022,CelestialInterface,1,444,325,377,259,118,98,12,4,2,2,0
22-03-2022,BitterLaser,2,672,400,263,204,59,78,28,33,14,19,2
22-03-2022,Aurora,1,383,133,194,84,110,79,41,74,18,56,7
22-03-2023,PrimeSeven,3,159,4,61,60,1,50,30,31,6,25,1
22-03-2023,Mustangs,3,172,85,28,26,2,78,0,29,21,8,2
22-03-2023,Honeycomb,2,443,100,414,309,105,51,50,0,0,0,0
22-03-2023,PrimeSeven,1,336,326,140,102,38,67,40,2,1,1,0
22-03-2023,Aurora,2,975,246,50,22,28,78,55,67,10,57,7
22-03-2023,Quicksilver,1,533,424,68,36,32,82,40,45,10,35,5
22-03-2023,Aurora,3,745,578,335,267,68,61,58,35,5,30,1
22-03-2023,Honeycomb,3,259,39,174,117,57,97,64,27,24,3,0
22-03-2023,Mustangs,1,458,14,140,91,49,73,40,51,42,9,0
22-03-2023,PrimeSeven,3,965,315,100,47,53,63,46,23,3,20,2
22-03-2023,ImpactTraining,2,430,428,158,145,13,89,34,40,36,4,3
22-04-2021,Honeycomb,2,421,192,245,210,35,96,59,72,29,43,6
22-04-2021,PrimeSeven,1,488,348,38,21,17,81,4,16,12,4,0
22-04-2021,BitterLaser,2,567,121,271,45,226,68,64,6,0,6,0
22-04-2021,CelestialInterface,1,488,427,389,176,213,65,22,23,4,19,0
22-04-2021,CelestialInterface,3,826,61,518,514,4,93,65,43,17,26,2
22-04-2021,PrimeSeven,3,633,39,31,11,20,78,77,11,8,3,0
22-04-2021,GrayPanthers,1,256,154,9,4,5,77,73,63,40,23,4
22-04-2021,Discovery,2,665,573,394,72,322,55,35,30,13,17,2
22-04-2021,ImpactTraining,1,739,613,28,3,25,51,31,10,6,4,0
22-04-2021,Quicksilver,2,244,123,185,12,173,65,61,9,0,9,0
22-04-2022,CelestialInterface,2,515,396,85,3,82,84,65,0,0,0,0
22-04-2022,Mustangs,1,859,631,772,261,511,59,58,46,9,37,1
22-04-2022,Mustangs,3,364,259,220,42,178,93,61,63,7,56,6
22-04-2022,Quicksilver,2,293,124,66,1,65,73,70,38,10,28,0
22-04-2022,GrayPanthers,1,703,20,513,208,305,82,76,28,11,17,3
22-04-2022,CelestialInterface,1,654,619,602,230,372,83,64,21,18,3,1
22-04-2022,PrimeSeven,3,113,40,71,68,3,91,60,21,13,8,0
22-04-2022,ImpactTraining,1,634,423,191,65,126,80,4,67,16,51,8
22-04-2023,Mustangs,3,346,159,205,123,82,89,63,28,3,25,0
22-04-2023,Honeycomb,3,630,438,247,223,24,85,47,51,19,32,0
22-04-2023,Mustangs,2,107,5,82,61,21,75,43,46,14,32,1
22-04-2023,Honeycomb,1,174,137,33,1,32,82,42,47,24,23,2
22-04-2023,PrimeSeven,2,146,90,1,0,1,99,81,28,26,2,2
22-04-2023,Mustangs,3,663,496,409,242,167,55,46,38,19,19,1
22-04-2023,Honeycomb,3,711,55,568,351,217,63,58,15,0,15,1
22-04-2023,Aurora,1,596,584,243,174,69,66,43,4,1,3,0
22-04-2023,Honeycomb,3,658,104,536,348,188,72,65,36,32,4,2
22-05-2021,BitterLaser,2,770,50,471,364,107,75,0,26,12,14,2
22-05-2021,Quicksilver,3,454,157,31,18,13,59,12,26,22,4,0
22-05-2021,ImpactTraining,3,342,105,220,63,157,77,21,24,7,17,0
22-05-2021,Discovery,1,844,606,616,212,404,65,50,9,3,6,0
22-05-2021,CelestialInterface,1,372,49,329,96,233,89,86,64,21,43,8
22-05-2021,GrayPanthers,1,477,224,21,1,20,73,48,54,4,50,6
22-05-2021,GrayPanthers,1,288,11,268,171,97,76,17,9,5,4,0
22-05-2021,CelestialInterface,1,924,474,354,273,81,92,16,57,42,15,3
22-05-2021,Quicksilver,3,981,228,147,96,51,82,56,21,8,13,0
22-05-2022,Discovery,2,767,200,204,130,74,59,27,39,20,19,0
22-05-2022,CelestialInterface,1,961,318,558,374,184,91,61,48,40,8,4
22-05-2022,PrimeSeven,2,437,344,149,139,10,80,66,75,4,71,7
22-05-2022,Honeycomb,1,941,141,849,590,259,60,19,49,11,38,3
22-05-2022,Honeycomb,2,337,15,193,116,77,66,36,20,1,19,1
22-05-2022,GrayPanthers,1,917,909,640,69,571,74,45,53,5,48,0
22-05-2022,CelestialInterface,3,250,87,103,37,66,71,4,12,0,12,0
22-05-2022,Quicksilver,1,296,75,257,102,155,96,10,48,31,17,6
22-05-2023,PrimeSeven,3,847,2,618,439,179,64,19,6,3,3,0
22-05-2023,BitterLaser,2,287,83,163,45,118,90,19,28,15,13,2
22-05-2023,Honeycomb,2,587,402,188,122,66,74,5,28,4,24,3
22-05-2023,Honeycomb,1,803,616,468,210,258,67,2,51,0,51,2
22-05-2023,PrimeSeven,3,764,519,583,558,25,95,75,8,7,1,0
22-05-2023,CelestialInterface,1,783,705,142,2,140,64,12,3,1,2,0
22-05-2023,Quicksilver,2,684,297,395,166,229,55,4,48,32,16,0
22-05-2023,Quicksilver,2,603,561,227,77,150,66,6,64,46,18,7
22-05-2023,Quicksilver,1,840,58,701,58,643,60,9,43,42,1,0
22-05-2023,Honeycomb,3,806,775,301,240,61,65,42,5,2,3,0
22-06-2021,ImpactTraining,1,552,227,249,53,196,100,87,80,0,80,1
22-06-2021,Aurora,1,564,524,522,141,381,86,40,70,66,4,3
22-06-2021,Honeycomb,1,846,648,768,233,535,88,25,44,21,23,1
22-06-2021,CelestialInterface,1,265,31,29,25,4,67,63,47,4,43,6
22-06-2021,PrimeSeven,1,118,74,90,4,86,60,4,55,12,43,7
22-06-2021,Discovery,2,796,91,783,158,625,51,22,31,26,5,2
22-06-2021,GrayPanthers,1,295,117,102,93,9,82,26,40,25,15,4
22-06-2021,CelestialInterface,3,483,31,146,89,57,69,9,42,15,27,1
22-06-2021,PrimeSeven,3,293,212,160,83,77,63,2,58,23,35,2
22-06-2022,Honeycomb,2,686,603,193,26,167,98,6,48,45,3,5
22-06-2022,ImpactTraining,3,963,773,612,552,60,54,37,8,4,4,0
22-06-2022,GrayPanthers,1,913,695,596,386,210,65,42,54,12,42,6
22-06-2022,Discovery,2,849,455,54,5,49,59,42,18,11,7,1
22-06-2022,PrimeSeven,3,555,316,109,39,70,68,10,42,7,35,5
22-06-2022,PrimeSeven,1,723,13,132,72,60,85,67,77,18,59,2
22-06-2022,Honeycomb,1,745,371,276,220,56,51,30,19,9,10,1
22-06-2022,BitterLaser,2,189,94,151,61,90,73,48,4,0,4,0
22-06-2022,Aurora,1,221,91,39,13,26,86,72,58,11,47,5
22-06-2022,Discovery,3,514,485,172,124,48,89,36,29,28,1,0
22-06-2022,ImpactTraining,2,487,400,45,11,34,99,13,17,15,2,0
22-06-2023,BitterLaser,3,486,421,332,128,204,59,21,4,2,2,0
22-06-2023,Mustangs,3,900,812,779,558,221,65,26,55,49,6,6
22-06-2023,BitterLaser,2,569,4,213,55,158,66,31,7,1,6,0
22-06-2023,BitterLaser,3,363,310,143,118,25,83,42,39,24,15,2
22-06-2023,Mustangs,3,709,57,111,17,94,57,48,6,2,4,0
22-06-2023,BitterLaser,3,734,168,265,208,57,92,30,11,4,7,0
22-06-2023,PrimeSeven,1,640,136,244,197,47,56,5,29,23,6,2
22-06-2023,CelestialInterface,1,666,339,576,124,452,89,36,87,31,56,6
22-06-2023,Mustangs,1,611,249,65,52,13,66,49,35,11,24,4
22-06-2023,PrimeSeven,3,843,397,709,47,662,57,44,15,4,11,0
22-07-2021,CelestialInterface,3,915,844,211,108,103,95,32,8,0,8,0
22-07-2021,PrimeSeven,2,883,352,775,608,167,66,17,12,9,3,0
22-07-2021,Mustangs,1,459,60,426,357,69,89,25,3,0,3,0
22-07-2021,BitterLaser,1,445,21,352,314,38,57,50,33,26,7,0
22-07-2021,Quicksilver,1,981,896,626,567,59,94,7,24,21,3,2
22-07-2021,ImpactTraining,3,741,236,723,39,684,84,6,30,6,24,0
22-07-2021,Mustangs,2,266,207,118,43,75,85,52,69,50,19,7
22-07-2021,Discovery,1,260,33,229,151,78,68,7,19,6,13,1
22-07-2021,Discovery,3,100,43,70,11,59,64,32,5,0,5,0
22-07-2021,Aurora,1,564,381,333,133,200,93,31,20,1,19,2
22-07-2021,Mustangs,2,806,480,146,80,66,96,26,78,70,8,2
22-07-2022,Aurora,1,511,134,163,32,131,79,17,7,0,7,0
22-07-2022,Discovery,3,586,134,51,2,49,53,18,32,1,31,2
22-07-2022,PrimeSeven,2,736,586,177,91,86,71,33,31,2,29,0
22-07-2022,Discovery,3,176,4,119,21,98,71,63,15,1,14,1
22-07-2022,PrimeSeven,1,873,862,757,503,254,59,5,45,40,5,5
22-07-2022,Honeycomb,1,699,136,352,220,132,88,13,23,14,9,0
22-07-2022,BitterLaser,1,122,37,45,24,21,70,49,2,1,1,0
22-07-2022,BitterLaser,1,228,197,186,95,91,54,20,53,22,31,4
22-07-2022,Honeycomb,2,237,231,146,81,65,96,66,51,30,21,1
22-07-2022,ImpactTraining,1,268,119,198,74,124,75,72,57,9,48,4
22-07-2022,Quicksilver,1,210,18,157,156,1,98,33,26,25,1,1
22-07-2022,Honeycomb,2,902,124,733,602,131,99,2,61,52,9,6
22-07-2022,BitterLaser,3,237,197,148,50,98,62,30,25,14,11,2
22-07-2023,Honeycomb,1,494,371,282,134,148,69,27,6,2,4,0
22-07-2023,GrayPanthers,3,410,319,224,53,171,78,3,59,31,28,7
22-07-2023,Quicksilver,1,784,373,119,84,35,76,5,20,0,20,0
22-07-2023,ImpactTraining,3,877,589,225,57,168,84,20,50,8,42,6
22-07-2023,Honeycomb,3,860,280,720,701,19,74,43,41,33,8,0
22-07-2023,PrimeSeven,3,837,737,228,192,36,86,43,69,44,25,9
22-07-2023,PrimeSeven,1,859,393,826,20,806,94,70,21,2,19,1
22-07-2023,Discovery,3,457,209,196,94,102,96,25,59,11,48,4
22-07-2023,Discovery,1,188,75,146,2,144,60,48,30,5,25,1
22-07-2023,Quicksilver,2,158,38,104,57,47,67,36,21,9,12,2
22-07-2023,Honeycomb,2,493,150,169,157,12,70,17,20,15,5,0
22-07-2023,Discovery,3,758,66,428,274,154,53,30,35,33,2,4
22-07-2023,Quicksilver,3,899,282,740,519,221,94,59,57,33,24,6
22-07-2023,Quicksilver,3,826,678,470,139,331,92,40,61,21,40,8
22-08-2021,PrimeSeven,2,368,355,179,52,127,56,5,17,4,13,0
22-08-2021,GrayPanthers,3,361,143,32,28,4,51,42,40,13,27,4
22-08-2021,BitterLaser,1,274,210,93,59,34,75,61,19,1,18,0
22-08-2021,Aurora,1,507,200,428,392,36,50,31,16,7,9,1
22-08-2021,Quicksilver,2,545,429,189,104,85,94,47,71,17,54,7
22-08-2021,ImpactTraining,2,938,105,486,221,265,100,52,96,78,18,4
22-08-2021,Quicksilver,3,298,77,226,140,86,58,3,6,2,4,0
22-08-2022,ImpactTraining,1,159,127,2,0,2,95,1,28,23,5,2
22-08-2022,Discovery,3,177,122,33,16,17,99,6,23,11,12,2
22-08-2022,Aurora,1,331,185,28,0,28,75,47,18,9,9,0
22-08-2022,Aurora,3,455,423,111,100,11,73,43,62,36,26,1
22-08-2022,Aurora,2,659,29,451,96,355,65,1,16,10,6,0
22-08-2022,Mustangs,2,944,399,735,325,410,76,35,49,5,44,5
22-08-2022,Discovery,3,540,522,136,7,129,57,48,22,14,8,2
22-08-2022,Mustangs,3,510,467,353,213,140,85,41,81,77,4,8
22-08-2022,Mustangs,2,690,450,404,233,171,82,21,67,57,10,4
22-08-2022,ImpactTraining,1,729,294,289,268,21,84,61,22,5,17,1
22-08-2022,ImpactTraining,1,828,803,605,181,424,71,10,41,11,30,4
22-08-2022,CelestialInterface,2,755,631,289,190,99,50,28,11,3,8,0
22-08-2023,GrayPanthers,3,341,6,199,125,74,65,18,43,15,28,3
22-08-2023,GrayPanthers,3,528,138,324,76,248,84,39,68,52,16,3
22-08-2023,Discovery,2,475,117,146,97,49,58,49,18,9,9,0
22-08-2023,Quicksilver,1,479,20,474,54,420,67,20,3,2,1,0
22-08-2023,GrayPanthers,2,832,356,275,273,2,89,81,63,19,44,4
22-08-2023,Discovery,1,337,119,122,23,99,78,66,7,5,2,0
22-08-2023,GrayPanthers,2,357,311,315,226,89,96,1,76,23,53,2
22-08-2023,CelestialInterface,2,664,435,342,322,20,61,44,45,34,11,3
22-08-2023,Discovery,2,462,285,27,7,20,71,4,17,6,11,0
22-08-2023,PrimeSeven,1,542,429,272,249,23,52,50,36,15,21,3
22-08-2023,Aurora,1,152,110,116,34,82,90,51,57,29,28,4
22-09-2021,Discovery,2,352,99,176,34,142,57,20,10,2,8,0
22-09-2021,Quicksilver,2,625,570,541,426,115,60,8,24,0,24,1
22-09-2021,Discovery,2,777,436,730,685,45,66,15,57,14,43,0
22-09-2021,GrayPanthers,1,644,97,167,42,125,60,16,2,1,1,0
22-09-2021,ImpactTraining,2,740,157,211,47,164,96,61,10,3,7,0
22-09-2021,Aurora,1,842,226,590,568,22,59,33,41,11,30,0
22-09-2021,Mustangs,3,219,182,143,30,113,83,11,75,14,61,9
22-09-2021,ImpactTraining,3,352,348,111,45,66,76,34,38,14,24,2
22-09-2021,GrayPanthers,2,625,94,614,120,494,86,45,56,13,43,2
22-09-2021,PrimeSeven,3,419,351,225,149,76,60,41,11,10,1,0
22-09-2021,Mustangs,3,344,323,95,6,89,69,54,7,4,3,0
22-09-2022,Discovery,3,466,401,228,174,54,95,66,29,7,22,3
22-09-2022,PrimeSeven,3,192,186,114,111,3,69,26,36,29,7,2
22-09-2022,PrimeSeven,3,417,260,267,177,90,94,62,64,18,46,8
22-09-2022,GrayPanthers,1,501,234,132,86,46,89,1,30,1,29,3
22-09-2022,Aurora,2,165,163,65,19,46,61,3,42,24,18,1
22-09-2022,Discovery,1,163,142,58,23,35,54,1,51,5,46,4
22-09-2022,ImpactTraining,3,902,420,405,131,274,61,59,39,31,8,0
22-09-2022,Honeycomb,2,244,91,98,26,72,52,25,30,14,16,2
22-09-2022,Aurora,1,432,267,418,378,40,57,55,41,38,3,4
22-09-2022,Discovery,1,511,372,492,234,258,79,21,64,22,42,3
22-09-2023,Aurora,3,410,309,358,107,251,79,36,77,57,20,10
22-09-2023,Aurora,3,779,18,427,404,23,85,72,2,0,2,0
22-09-2023,Quicksilver,2,651,638,596,559,37,90,71,80,43,37,8
22-09-2023,CelestialInterface,3,936,439,109,55,54,90,86,2,1,1,0
22-09-2023,Discovery,2,287,151,59,42,17,90,8,64,55,9,4
22-09-2023,GrayPanthers,2,607,449,470,38,432,63,44,35,27,8,2
22-09-2023,CelestialInterface,1,749,186,363,189,174,73,58,31,29,2,0
22-09-2023,Quicksilver,3,336,140,219,150,69,66,12,22,7,15,2
22-09-2023,Mustangs,3,631,587,484,405,79,100,4,48,4,44,3
22-09-2023,Discovery,1,528,291,235,74,161,99,51,18,11,7,1
22-09-2023,Discovery,2,502,275,87,29,58,86,5,46,1,45,3
22-09-2023,Quicksilver,3,489,150,171,76,95,53,12,5,1,4,0
22-09-2023,Discovery,1,140,128,107,39,68,79,43,17,6,11,0
22-09-2023,Quicksilver,1,610,253,415,317,98,92,88,27,4,23,1
22-10-2021,ImpactTraining,1,355,41,292,241,51,75,56,17,5,12,0
22-10-2021,PrimeSeven,1,445,230,418,182,236,79,78,41,37,4,4
22-10-2021,ImpactTraining,2,478,51,338,187,151,95,8,52,1,51,0
22-10-2021,Discovery,2,130,76,22,5,17,70,3,15,9,6,0
22-10-2021,GrayPanthers,2,915,131,109,106,3,91,33,22,17,5,0
22-10-2021,Mustangs,1,856,198,237,170,67,53,35,16,2,14,0
22-10-2021,Aurora,2,832,124,610,86,524,59,42,27,10,17,1
22-10-2021,CelestialInterface,1,795,370,285,63,222,73,49,25,17,8,1
22-10-2021,Aurora,3,376,124,329,23,306,53,1,37,35,2,1
22-10-2021,Aurora,2,830,697,80,11,69,88,41,56,27,29,0
22-10-2022,Quicksilver,2,811,591,701,518,183,66,7,15,6,9,1
22-10-2022,PrimeSeven,1,584,327,312,156,156,60,33,38,7,31,2
22-10-2022,Quicksilver,2,309,14,53,14,39,95,41,83,8,75,7
22-10-2022,Mustangs,1,326,29,110,95,15,69,51,10,8,2,0
22-10-2022,ImpactTraining,1,870,198,651,439,212,54,42,33,6,27,2
22-10-2022,Mustangs,3,807,715,161,56,105,82,21,60,7,53,7
22-10-2022,Mustangs,1,986,626,447,70,377,50,39,38,24,14,3
22-10-2023,PrimeSeven,3,929,424,800,541,259,79,35,53,24,29,6
22-10-2023,Aurora,2,727,206,347,202,145,80,32,65,62,3,3
22-10-2023,Discovery,3,842,15,491,262,229,100,42,55,51,4,5
22-10-2023,ImpactTraining,2,349,233,341,78,263,81,36,51,11,40,4
22-10-2023,Quicksilver,2,264,9,70,68,2,62,2,53,29,24,2
22-10-2023,Discovery,1,268,142,172,28,144,65,13,18,9,9,1
22-10-2023,CelestialInterface,1,857,495,411,327,84,57,22,37,8,29,4
22-10-2023,CelestialInterface,2,541,218,422,162,260,64,2,16,11,5,0
22-10-2023,Honeycomb,1,179,26,60,24,36,90,43,23,22,1,0
22-10-2023,Quicksilver,3,223,81,59,37,22,58,0,10,1,9,0
22-10-2023,GrayPanthers,3,145,104,54,40,14,79,41,61,52,9,8
22-10-2023,BitterLaser,2,890,728,736,495,241,89,80,23,18,5,2
22-10-2023,GrayPanthers,2,484,73,476,182,294,94,51,41,39,2,0
22-10-2023,Discovery,1,439,23,335,195,140,59,6,50,48,2,2
22-10-2023,BitterLaser,1,569,376,144,87,57,73,16,2,1,1,0
22-10-2023,BitterLaser,2,789,271,391,238,153,74,14,69,30,39,9
22-10-2023,Discovery,2,341,137,48,26,22,99,72,92,68,24,9
22-10-2023,Discovery,1,145,89,36,29,7,60,31,28,16,12,0
22-11-2021,BitterLaser,1,284,115,176,175,1,96,84,61,8,53,5
22-11-2021,GrayPanthers,1,492,66,480,128,352,77,11,29,27,2,2
22-11-2021,Mustangs,3,442,345,63,62,1,93,85,58,18,40,3
22-11-2021,BitterLaser,2,541,10,449,369,80,76,68,39,6,33,4
22-11-2021,PrimeSeven,2,966,25,886,336,550,82,57,21,14,7,1
22-11-2021,CelestialInterface,2,733,636,29,15,14,76,39,60,5,55,7
22-11-2021,BitterLaser,1,219,81,9,3,6,67,21,62,35,27,1
22-11-2021,Mustangs,3,999,92,734,327,407,89,76,27,15,12,1
22-11-2022,PrimeSeven,3,850,666,395,300,95,81,24,21,4,17,2
22-11-2022,ImpactTraining,1,682,649,571,535,36,72,17,50,20,30,3
22-11-2022,Quicksilver,3,651,24,636,5,631,74,29,73,67,6,0
22-11-2022,PrimeSeven,1,225,69,216,203,13,84,43,65,20,45,6
22-11-2022,ImpactTraining,1,947,155,425,139,286,68,38,65,51,14,2
22-11-2022,Discovery,1,384,370,1,0,1,85,0,74,61,13,7
22-11-2022,Quicksilver,1,827,296,603,107,496,63,42,2,0,2,0
22-11-2022,PrimeSeven,1,109,41,14,13,1,86,81,13,4,9,0
22-11-2022,Discovery,1,355,170,95,19,76,53,27,23,16,7,1
22-11-2022,Aurora,2,895,37,435,146,289,90,66,85,13,72,10
22-11-2022,Mustangs,2,358,100,37,9,28,96,69,11,1,10,0
22-11-2022,ImpactTraining,1,504,79,236,232,4,81,71,69,29,40,1
22-11-2022,Mustangs,3,837,299,382,318,64,77,70,34,26,8,2
22-11-2022,PrimeSeven,1,229,117,102,5,97,96,70,45,23,22,4
22-11-2022,Quicksilver,2,848,644,623,391,232,85,2,9,3,6,0
22-11-2023,Discovery,2,156,85,88,72,16,89,16,53,18,35,4
22-11-2023,Quicksilver,3,561,27,223,193,30,64,34,9,8,1,0
22-11-2023,ImpactTraining,1,626,331,45,8,37,62,59,14,1,13,0
22-11-2023,ImpactTraining,1,399,344,138,91,47,82,59,75,22,53,0
22-11-2023,Quicksilver,2,556,539,407,398,9,78,21,63,41,22,1
22-11-2023,Quicksilver,3,366,267,9,1,8,64,43,14,11,3,0
22-11-2023,PrimeSeven,2,329,5,261,25,236,78,69,4,2,2,0
22-12-2021,CelestialInterface,1,460,13,420,74,346,94,58,44,42,2,5
22-12-2021,Discovery,1,298,31,27,7,20,95,1,85,69,16,10
22-12-2021,Aurora,2,401,290,338,308,30,70,43,4,3,1,0
22-12-2021,PrimeSeven,1,205,109,57,9,48,58,16,16,8,8,0
22-12-2021,CelestialInterface,2,575,306,244,211,33,79,10,23,11,12,2
22-12-2021,PrimeSeven,3,141,136,53,43,10,77,62,58,24,34,3
22-12-2021,Mustangs,3,669,396,93,28,65,96,4,40,22,18,3
22-12-2021,BitterLaser,1,903,487,651,253,398,75,8,4,0,4,0
22-12-2021,PrimeSeven,2,467,151,32,19,13,85,33,30,1,29,1
22-12-2021,GrayPanthers,3,829,506,543,68,475,77,50,20,1,19,0
22-12-2021,BitterLaser,1,367,138,221,12,209,100,91,54,4,50,0
22-12-2021,Mustangs,2,671,432,309,85,224,81,48,1,0,1,0
22-12-2022,GrayPanthers,1,101,69,85,77,8,53,12,34,15,19,4
22-12-2022,GrayPanthers,1,680,593,640,116,524,85,28,10,7,3,0
22-12-2022,CelestialInterface,2,518,81,89,47,42,52,0,43,1,42,4
22-12-2022,Quicksilver,1,732,198,462,321,141,81,39,2,0,2,0
22-12-2022,Honeycomb,3,633,225,371,117,254,68,63,18,13,5,0
22-12-2022,Mustangs,3,312,56,171,25,146,88,65,83,39,44,0
22-12-2022,BitterLaser,2,927,531,463,186,277,63,22,13,7,6,0
22-12-2022,CelestialInterface,3,243,38,233,20,213,56,13,9,5,4,0
22-12-2022,Discovery,2,520,14,471,428,43,65,45,30,22,8,2
22-12-2022,CelestialInterface,1,757,294,269,37,232,89,43,50,39,11,0
22-12-2022,GrayPanthers,1,145,40,128,3,125,71,47,18,9,9,0
22-12-2022,Quicksilver,3,912,144,315,237,78,57,44,32,9,23,3
22-12-2022,Mustangs,1,343,279,300,185,115,61,55,51,39,12,0
22-12-2022,Honeycomb,3,626,43,224,43,181,63,40,1,0,1,0
22-12-2023,GrayPanthers,1,353,44,255,208,47,68,59,15,10,5,1
22-12-2023,Aurora,2,969,11,179,74,105,72,17,69,25,44,2
22-12-2023,PrimeSeven,3,124,20,38,8,30,73,45,18,1,17,1
22-12-2023,CelestialInterface,2,304,64,273,18,255,93,14,66,47,19,5
22-12-2023,Honeycomb,3,363,211,235,89,146,84,56,74,22,52,8
22-12-2023,Discovery,3,888,194,124,34,90,62,6,20,1,19,2
22-12-2023,Quicksilver,2,549,9,26,21,5,60,45,49,44,5,0
22-12-2023,Quicksilver,2,118,0,73,66,7,71,28,66,20,46,5
22-12-2023,CelestialInterface,3,921,393,53,4,49,78,42,74,69,5,4
22-12-2023,ImpactTraining,1,646,457,483,27,456,96,69,40,3,37,0
23-01-2021,GrayPanthers,3,348,189,70,14,56,78,27,48,34,14,3
23-01-2021,BitterLaser,2,609,585,136,19,117,94,45,80,41,39,10
23-01-2021,ImpactTraining,1,183,77,122,11,111,52,48,12,9,3,0
23-01-2021,Quicksilver,3,555,493,370,347,23,72,5,5,0,5,0
23-01-2021,Discovery,1,358,227,109,100,9,72,70,55,23,32,0
23-01-2021,Quicksilver,3,341,62,265,177,88,93,5,18,4,14,0
23-01-2021,ImpactTraining,2,703,541,52,21,31,63,8,2,1,1,0
23-01-2021,PrimeSeven,1,907,513,498,11,487,84,20,39,22,17,2
23-01-2022,BitterLaser,3,888,419,117,48,69,61,25,26,13,13,2
23-01-2022,Aurora,2,347,278,149,49,100,79,70,4,0,4,0
23-01-2022,GrayPanthers,2,800,598,550,109,441,68,21,11,8,3,0
23-01-2022,Mustangs,1,531,3,469,76,393,55,49,26,16,10,0
23-01-2022,PrimeSeven,1,336,323,34,8,26,60,56,7,6,1,0
23-01-2022,BitterLaser,2,905,124,81,28,53,78,75,38,16,22,0
23-01-2023,PrimeSeven,3,590,94,317,20,297,54,0,34,4,30,3
23-01-2023,Discovery,2,577,114,322,304,18,64,55,50,2,48,3
23-01-2023,CelestialInterface,2,391,324,146,61,85,83,6,44,26,18,4
23-01-2023,ImpactTraining,1,537,127,96,0,96,78,56,69,65,4,9
23-01-2023,CelestialInterface,1,392,363,78,64,14,75,1,10,2,8,0
23-01-2023,Discovery,2,994,289,46,22,24,69,37,21,12,9,1
23-01-2023,CelestialInterface,2,358,304,259,149,110,71,33,22,5,17,0
23-01-2023,Aurora,3,927,309,443,81,362,52,24,37,1,36,3
23-01-2023,PrimeSeven,3,142,21,99,35,64,89,80,57,38,19,1
23-02-2021,Honeycomb,1,731,221,331,24,307,65,16,47,11,36,0
23-02-2021,Discovery,1,108,95,11,2,9,96,41,47,31,16,4
23-02-2021,BitterLaser,2,961,215,177,117,60,52,30,27,17,10,1
23-02-2021,Discovery,1,937,864,700,591,109,85,46,26,20,6,0
23-02-2021,BitterLaser,1,764,603,336,240,96,55,47,13,3,10,0
23-02-2021,Aurora,2,174,150,72,46,26,82,23,26,13,13,1
23-02-2021,BitterLaser,2,363,302,221,179,42,50,18,45,17,28,5
23-02-2022,BitterLaser,2,134,31,90,9,81,98,36,78,75,3,3
23-02-2022,ImpactTraining,2,554,278,438,132,306,96,74,81,60,21,4
23-02-2022,Discovery,1,849,208,669,279,390,89,47,53,45,8,5
23-02-2022,ImpactTraining,1,757,475,422,146,276,50,25,49,14,35,1
23-02-2022,Discovery,3,405,13,385,113,272,59,54,32,22,10,3
23-02-2022,Aurora,3,750,228,195,47,148,72,18,19,9,10,1
23-02-2022,BitterLaser,2,558,190,21,16,5,94,16,55,42,13,7
23-02-2022,PrimeSeven,3,636,578,210,69,141,78,75,35,31,4,2
23-02-2023,Honeycomb,3,488,390,209,90,119,68,12,55,23,32,2
23-02-2023,Quicksilver,3,394,186,151,116,35,56,52,35,14,21,4
23-02-2023,Mustangs,3,152,82,116,82,34,85,67,60,12,48,8
23-02-2023,GrayPanthers,1,754,599,305,197,108,84,67,83,28,55,9
23-02-2023,Mustangs,2,330,244,37,17,20,98,38,19,5,14,0
23-02-2023,ImpactTraining,1,429,301,84,3,81,54,37,47,6,41,0
23-02-2023,GrayPanthers,2,445,206,191,123,68,68,14,6,1,5,0
23-02-2023,ImpactTraining,1,806,659,383,119,264,87,33,69,30,39,1
23-02-2023,Honeycomb,1,442,374,144,75,69,89,64,56,24,32,1
23-03-2021,Discovery,2,546,382,525,25,500,66,25,17,6,11,0
23-03-2021,Honeycomb,1,714,90,556,401,155,79,43,26,14,12,1
23-03-2021,Honeycomb,1,320,317,67,66,1,79,32,20,9,11,2
23-03-2021,CelestialInterface,1,110,36,49,19,30,96,38,77,12,65,6
23-03-2021,GrayPanthers,1,314,164,48,31,17,68,19,45,38,7,3
23-03-2021,ImpactTraining,2,206,194,171,69,102,60,43,42,10,32,1
23-03-2021,Mustangs,1,357,81,5,3,2,56,13,15,11,4,1
23-03-2021,Honeycomb,3,257,156,86,52,34,78,48,18,12,6,0
23-03-2021,PrimeSeven,1,621,543,384,116,268,90,15,38,19,19,4
23-03-2021,BitterLaser,1,378,44,231,186,45,78,7,28,21,7,0
23-03-2021,Aurora,1,706,229,180,25,155,55,19,54,41,13,0
23-03-2022,PrimeSeven,2,526,412,265,135,130,84,35,4,3,1,0
23-03-2022,Discovery,1,418,18,28,17,11,81,22,68,48,20,4
23-03-2022,PrimeSeven,2,824,516,591,576,15,88,72,52,22,30,4
23-03-2022,Discovery,3,635,334,335,269,66,74,13,18,14,4,1
23-03-2022,CelestialInterface,1,585,65,101,58,43,90,77,11,5,6,0
23-03-2022,ImpactTraining,1,205,73,4,3,1,53,15,0,0,0,0
23-03-2023,BitterLaser,2,112,88,91,80,11,69,68,50,13,37,6
23-03-2023,ImpactTraining,2,902,290,348,320,28,67,5,9,6,3,0
23-03-2023,Aurora,3,460,406,386,91,295,81,12,4,2,2,0
23-03-2023,ImpactTraining,2,192,82,106,20,86,87,74,83,23,60,3
23-04-2021,PrimeSeven,2,517,289,73,27,46,89,45,66,7,59,2
23-04-2021,CelestialInterface,1,472,446,70,58,12,71,17,55,44,11,4
23-04-2021,Honeycomb,1,540,5,87,59,28,85,75,40,34,6,3
23-04-2021,Discovery,1,907,328,734,129,605,69,45,58,10,48,5
23-04-2021,CelestialInterface,3,466,181,203,65,138,96,66,27,4,23,3
23-04-2021,Quicksilver,2,208,3,71,8,63,73,72,0,0,0,0
23-04-2021,Honeycomb,2,453,185,390,170,220,59,27,54,17,37,2
23-04-2021,Honeycomb,1,802,172,740,515,225,100,87,69,65,4,6
23-04-2021,Mustangs,2,699,261,698,528,170,92,47,1,0,1,0
23-04-2021,Mustangs,3,269,179,126,118,8,71,46,64,11,53,0
23-04-2021,GrayPanthers,1,903,248,40,12,28,61,47,14,5,9,0
23-04-2021,ImpactTraining,3,904,372,379,189,190,75,7,51,37,14,2
23-04-2021,Quicksilver,2,324,106,32,3,29,66,44,53,30,23,1
23-04-2021,Mustangs,1,863,529,37,17,20,55,28,14,8,6,0
23-04-2021,Honeycomb,2,805,765,231,213,18,92,59,91,57,34,3
23-04-2021,PrimeSeven,1,483,217,348,159,189,53,19,3,2,1,0
23-04-2022,BitterLaser,1,731,38,115,52,63,93,35,49,14,35,0
23-04-2022,Quicksilver,1,153,19,128,98,30,71,58,55,8,47,5
23-04-2022,Honeycomb,2,739,685,340,302,38,51,30,15,10,5,0
23-04-2022,CelestialInterface,1,155,3,45,15,30,80,27,44,39,5,4
23-04-2022,Quicksilver,1,657,439,608,602,6,70,36,10,8,2,0
23-04-2022,CelestialInterface,3,702,233,274,61,213,66,62,14,8,6,0
23-04-2022,GrayPanthers,1,707,30,472,61,411,67,38,66,55,11,7
23-04-2022,Discovery,3,563,25,523,414,109,73,27,23,7,16,2
23-04-2022,CelestialInterface,1,633,527,570,386,184,55,30,41,24,17,5
23-04-2022,BitterLaser,2,546,347,526,170,356,82,71,26,18,8,2
23-04-2022,Quicksilver,2,416,226,109,66,43,52,39,38,10,28,0
23-04-2022,ImpactTraining,3,510,284,193,20,173,67,10,52,24,28,3
23-04-2022,Aurora,1,614,158,46,19,27,74,51,0,0,0,0
23-04-2022,Honeycomb,2,151,40,89,6,83,65,42,9,2,7,0
23-04-2022,Honeycomb,2,448,37,124,80,44,94,91,35,22,13,1
23-04-2023,PrimeSeven,3,724,610,647,103,544,96,82,34,33,1,4
23-04-2023,Quicksilver,1,830,210,296,154,142,71,7,1,0,1,0
23-04-2023,Honeycomb,3,146,141,138,112,26,87,39,60,53,7,5
23-04-2023,GrayPanthers,3,420,183,160,5,155,64,21,45,33,12,1
23-04-2023,Aurora,2,109,24,30,12,18,52,21,35,10,25,0
23-04-2023,Discovery,1,459,61,215,159,56,76,66,18,11,7,0
23-04-2023,PrimeSeven,1,269,182,114,37,77,75,19,49,40,9,3
23-04-2023,Discovery,2,382,87,130,126,4,93,45,30,17,13,2
23-04-2023,Mustangs,2,545,465,281,217,64,84,30,18,3,15,1
23-05-2021,BitterLaser,3,878,27,154,134,20,61,29,60,49,11,7
23-05-2021,ImpactTraining,3,176,78,8,0,8,50,28,9,2,7,0
23-05-2021,CelestialInterface,3,596,349,320,317,3,80,34,13,3,10,0
23-05-2021,GrayPanthers,2,600,50,55,11,44,68,55,13,2,11,0
23-05-2021,Discovery,1,265,42,128,16,112,86,83,53,4,49,4
23-05-2021,Mustangs,3,990,741,827,468,359,82,7,50,40,10,5
23-05-2021,BitterLaser,3,100,6,80,32,48,72,47,19,16,3,0
23-05-2021,BitterLaser,2,148,25,133,31,102,72,40,31,3,28,3
23-05-2021,Discovery,3,864,642,681,86,595,75,5,48,32,16,5
23-05-2021,CelestialInterface,2,732,478,358,240,118,52,3,38,26,12,4
23-05-2021,ImpactTraining,1,800,299,308,122,186,68,21,34,23,11,2
23-05-2022,CelestialInterface,1,865,163,276,270,6,64,20,46,2,44,4
23-05-2022,Discovery,2,785,588,497,82,415,94,47,53,0,53,3
23-05-2022,Aurora,3,643,628,503,178,325,95,10,80,69,11,6
23-05-2022,ImpactTraining,2,291,268,203,163,40,66,14,65,28,37,7
23-05-2022,GrayPanthers,2,717,121,105,60,45,75,54,47,25,22,0
23-05-2022,Aurora,3,932,845,381,2,379,62,10,14,7,7,1
23-05-2022,PrimeSeven,1,816,162,362,305,57,76,11,32,7,25,0
23-05-2022,BitterLaser,2,775,375,296,129,167,85,53,81,66,15,2
23-05-2022,BitterLaser,3,814,118,393,131,262,59,23,0,0,0,0
23-05-2022,ImpactTraining,1,711,594,138,83,55,63,50,44,15,29,2
23-05-2022,ImpactTraining,1,887,596,124,54,70,86,42,21,19,2,2
23-05-2022,PrimeSeven,2,375,179,196,146,50,50,6,30,21,9,1
23-05-2023,Mustangs,1,913,276,226,70,156,53,20,7,3,4,0
23-05-2023,Aurora,2,401,109,15,5,10,81,0,59,18,41,1
23-05-2023,Discovery,1,639,590,361,358,3,96,9,79,53,26,2
23-05-2023,BitterLaser,1,730,212,329,233,96,90,27,38,19,19,4
23-05-2023,Mustangs,1,833,120,762,284,478,73,20,10,2,8,0
23-05-2023,Honeycomb,2,186,180,28,8,20,71,4,63,23,40,7
23-05-2023,CelestialInterface,1,154,22,56,6,50,57,34,41,3,38,4
23-06-2021,PrimeSeven,3,733,245,149,5,144,53,46,44,1,43,3
23-06-2021,ImpactTraining,1,101,93,77,21,56,88,21,0,0,0,0
23-06-2021,Quicksilver,2,623,36,193,110,83,88,40,43,14,29,5
23-06-2021,Quicksilver,1,744,30,550,281,269,91,40,74,21,53,1
23-06-2021,Mustangs,2,745,668,620,285,335,50,6,14,13,1,1
23-06-2021,Honeycomb,3,815,806,291,115,176,94,84,26,1,25,2
23-06-2021,Quicksilver,2,861,449,247,194,53,57,50,26,21,5,0
23-06-2021,Honeycomb,1,384,344,364,123,241,99,36,98,28,70,1
23-06-2021,CelestialInterface,3,546,376,232,180,52,91,87,32,24,8,1
23-06-2021,GrayPanthers,3,187,81,11,4,7,81,53,68,59,9,3
23-06-2022,CelestialInterface,2,221,106,141,87,54,72,70,9,6,3,0
23-06-2022,Discovery,2,198,24,178,115,63,97,50,2,1,1,0
23-06-2022,GrayPanthers,3,426,122,29,24,5,73,10,21,10,11,2
23-06-2022,Quicksilver,3,982,560,238,104,134,63,7,36,18,18,4
23-06-2022,Honeycomb,3,449,136,229,14,215,65,58,2,0,2,0
23-06-2022,Honeycomb,1,199,140,136,66,70,52,10,7,2,5,0
23-06-2022,GrayPanthers,3,934,58,856,262,594,87,37,22,4,18,1
23-06-2022,CelestialInterface,1,388,320,31,20,11,87,51,58,11,47,3
23-06-2023,GrayPanthers,2,593,184,138,80,58,94,53,14,6,8,0
23-06-2023,PrimeSeven,1,503,91,426,408,18,84,74,41,12,29,0
23-06-2023,Discovery,2,576,166,290,206,84,59,57,4,1,3,0
23-06-2023,Discovery,3,471,336,337,135,202,95,82,33,4,29,3
23-06-2023,Aurora,1,928,606,43,27,16,60,30,43,33,10,5
23-06-2023,GrayPanthers,2,293,88,58,57,1,60,19,22,16,6,2
23-06-2023,Discovery,1,103,65,3,1,2,80,39,63,4,59,7
23-06-2023,Quicksilver,1,817,374,296,242,54,76,21,47,5,42,6
23-06-2023,Discovery,2,792,571,516,72,444,82,48,30,1,29,0
23-07-2021,BitterLaser,1,487,171,399,137,262,79,69,56,45,11,6
23-07-2021,Discovery,2,570,497,64,23,41,91,86,47,44,3,1
23-07-2021,CelestialInterface,1,305,140,222,212,10,84,76,0,0,0,0
23-07-2021,BitterLaser,1,674,639,59,22,37,54,0,16,5,11,1
23-07-2021,ImpactTraining,3,280,39,114,87,27,81,57,12,4,8,0
23-07-2021,Discovery,1,996,906,33,4,29,69,54,56,43,13,7
23-07-2021,Mustangs,2,745,724,619,196,423,95,61,54,20,34,3
23-07-2021,Mustangs,1,197,148,101,23,78,55,24,40,9,31,3
23-07-2021,ImpactTraining,1,232,13,229,78,151,62,58,12,0,12,0
23-07-2021,Aurora,1,545,316,92,54,38,56,11,30,15,15,0
23-07-2021,Honeycomb,2,126,63,25,0,25,63,19,16,2,14,0
23-07-2022,PrimeSeven,2,301,141,137,117,20,98,92,17,16,1,0
23-07-2022,PrimeSeven,1,805,658,20,5,15,53,43,22,18,4,0
23-07-2022,PrimeSeven,2,776,254,334,25,309,96,28,14,11,3,0
23-07-2022,Aurora,2,331,144,316,91,225,94,60,35,21,14,2
23-07-2022,Quicksilver,2,481,289,151,71,80,80,34,76,24,52,4
23-07-2022,Honeycomb,3,281,125,141,121,20,94,48,2,1,1,0
23-07-2022,PrimeSeven,3,782,763,672,607,65,72,29,54,49,5,5
23-07-2022,Aurora,3,215,21,160,66,94,94,19,89,34,55,12
23-07-2022,BitterLaser,1,447,287,199,128,71,64,55,56,23,33,0
23-07-2022,ImpactTraining,2,627,99,40,16,24,88,76,56,51,5,5
23-07-2022,PrimeSeven,2,419,250,156,66,90,93,13,18,2,16,1
23-07-2022,ImpactTraining,1,642,134,325,315,10,62,19,44,32,12,5
23-07-2023,BitterLaser,1,263,234,218,64,154,73,14,70,0,70,2
23-07-2023,BitterLaser,3,458,365,339,318,21,96,77,3,0,3,0
23-07-2023,GrayPanthers,3,330,312,287,90,197,58,19,26,6,20,1
23-07-2023,Aurora,2,362,55,40,15,25,93,16,9,5,4,0
23-07-2023,BitterLaser,3,256,249,130,8,122,81,29,6,4,2,0
23-07-2023,Discovery,2,945,61,629,32,597,100,0,30,24,6,0
23-07-2023,CelestialInterface,3,159,92,72,69,3,51,13,13,1,12,0
23-07-2023,PrimeSeven,1,410,72,179,89,90,75,43,15,5,10,1
23-07-2023,Mustangs,3,112,80,27,23,4,95,94,84,58,26,6
23-08-2021,CelestialInterface,1,237,201,163,61,102,76,44,29,17,12,2
23-08-2021,Aurora,3,600,596,119,73,46,90,54,81,27,54,0
23-08-2021,Aurora,1,624,496,224,15,209,84,66,51,26,25,3
23-08-2021,Mustangs,1,665,121,376,4,372,96,15,86,10,76,5
23-08-2021,BitterLaser,2,665,299,204,84,120,51,5,50,24,26,4
23-08-2021,Mustangs,1,441,343,85,24,61,62,14,0,0,0,0
23-08-2021,CelestialInterface,1,346,59,148,97,51,98,57,45,36,9,4
23-08-2021,ImpactTraining,1,750,48,70,33,37,54,10,13,2,11,0
23-08-2021,Mustangs,3,521,17,265,47,218,68,44,51,41,10,0
23-08-2021,PrimeSeven,3,431,18,222,8,214,75,28,59,44,15,0
23-08-2021,Quicksilver,2,646,641,588,254,334,57,3,49,37,12,4
23-08-2021,BitterLaser,1,432,113,150,1,149,90,57,53,18,35,3
23-08-2022,Quicksilver,2,372,265,174,79,95,58,54,53,25,28,6
23-08-2022,Quicksilver,2,995,246,856,660,196,62,4,51,23,28,1
23-08-2022,Mustangs,1,888,49,568,28,540,66,65,6,3,3,0
23-08-2022,Aurora,2,981,728,590,487,103,68,48,64,43,21,3
23-08-2022,CelestialInterface,3,388,231,163,53,110,76,9,16,0,16,1
23-08-2022,ImpactTraining,2,860,534,255,100,155,82,46,48,16,32,0
23-08-2022,Discovery,1,278,210,156,137,19,78,4,44,5,39,1
23-08-2022,PrimeSeven,1,302,187,73,45,28,94,22,42,26,16,1
23-08-2022,BitterLaser,2,686,170,341,158,183,93,75,35,24,11,4
23-08-2023,Aurora,3,737,666,489,218,271,94,80,48,27,21,5
23-08-2023,BitterLaser,2,854,276,784,259,525,85,72,16,7,9,0
23-08-2023,CelestialInterface,2,305,199,85,11,74,100,21,17,16,1,0
23-08-2023,Mustangs,2,817,349,772,637,135,50,42,14,9,5,1
23-08-2023,Aurora,1,872,171,213,131,82,99,63,28,14,14,0
23-08-2023,Discovery,3,258,12,250,118,132,93,10,15,11,4,1
23-08-2023,Mustangs,1,374,35,55,29,26,74,52,0,0,0,0
23-09-2021,Mustangs,1,415,98,38,14,24,93,86,42,3,39,5
23-09-2021,CelestialInterface,1,709,439,627,501,126,100,7,49,37,12,3
23-09-2021,Discovery,1,405,218,277,113,164,78,60,26,18,8,2
23-09-2021,GrayPanthers,1,733,313,414,0,414,93,38,22,12,10,1
23-09-2021,Quicksilver,2,939,33,925,22,903,86,54,38,28,10,2
23-09-2021,BitterLaser,1,919,391,49,11,38,61,46,38,6,32,1
23-09-2022,Quicksilver,3,771,639,478,321,157,57,48,14,3,11,0
23-09-2022,Discovery,2,227,37,150,119,31,75,38,73,61,12,9
23-09-2022,Mustangs,3,713,111,681,365,316,94,88,22,5,17,0
23-09-2022,GrayPanthers,3,917,65,215,74,141,94,64,18,14,4,0
23-09-2022,Quicksilver,1,675,645,302,201,101,91,44,64,61,3,8
23-09-2022,PrimeSeven,1,948,941,32,19,13,96,46,85,44,41,10
23-09-2022,Quicksilver,2,987,6,806,495,311,83,82,40,23,17,0
23-09-2022,Aurora,2,660,316,657,422,235,88,35,70,17,53,2
23-09-2022,PrimeSeven,1,113,106,23,7,16,74,41,18,6,12,1
23-09-2022,Quicksilver,2,331,84,1,0,1,67,31,54,36,18,2
23-09-2022,Honeycomb,2,188,39,163,155,8,99,51,30,24,6,3
23-09-2022,Mustangs,2,380,155,240,226,14,88,6,53,8,45,6
23-09-2023,GrayPanthers,3,682,42,212,85,127,69,16,24,10,14,0
23-09-2023,Quicksilver,1,382,253,282,2,280,53,14,4,3,1,0
23-09-2023,Aurora,1,204,128,15,9,6,77,39,57,54,3,2
23-09-2023,Aurora,3,842,675,816,696,120,81,13,59,19,40,3
23-09-2023,Quicksilver,3,457,181,317,108,209,55,39,4,3,1,0
23-09-2023,CelestialInterface,1,233,187,48,16,32,92,82,53,37,16,2
23-09-2023,Discovery,1,566,449,217,200,17,83,42,35,14,21,3
23-09-2023,Mustangs,1,994,418,718,536,182,66,4,35,26,9,1
23-09-2023,BitterLaser,1,984,546,269,133,136,91,23,22,3,19,1
23-09-2023,Aurora,2,376,308,160,132,28,57,6,49,39,10,2
23-09-2023,Mustangs,3,384,63,275,235,40,55,0,0,0,0,0
23-09-2023,CelestialInterface,3,237,158,27,23,4,62,35,42,31,11,2
23-10-2021,ImpactTraining,3,825,314,793,515,278,95,0,65,43,22,1
23-10-2021,ImpactTraining,2,506,447,160,13,147,68,46,17,8,9,0
23-10-2021,Discovery,1,600,421,561,169,392,87,77,29,25,4,1
23-10-2021,ImpactTraining,3,590,348,486,483,3,64,8,55,8,47,0
23-10-2021,Quicksilver,2,147,57,63,16,47,66,24,61,14,47,1
23-10-2021,BitterLaser,3,845,798,265,221,44,78,6,24,4,20,2
23-10-2022,Quicksilver,1,766,211,8,4,4,93,47,77,43,34,6
23-10-2022,GrayPanthers,2,310,47,260,68,192,57,7,25,22,3,1
23-10-2022,Aurora,1,622,65,106,100,6,50,0,46,13,33,5
23-10-2022,CelestialInterface,1,970,661,103,60,43,96,48,46,26,20,0
23-10-2022,Quicksilver,3,289,183,225,44,181,66,57,65,4,61,7
23-10-2022,Discovery,2,207,142,52,44,8,71,29,55,8,47,1
23-10-2022,Mustangs,1,158,115,120,59,61,67,41,52,49,3,6
23-10-2023,GrayPanthers,1,753,318,707,252,455,93,84,49,29,20,3
23-10-2023,Honeycomb,3,232,150,214,165,49,63,11,60,40,20,2
23-10-2023,Quicksilver,1,302,128,7,6,1,90,86,27,18,9,2
23-10-2023,GrayPanthers,2,485,252,419,289,130,70,35,67,14,53,6
23-10-2023,Discovery,2,183,92,31,19,12,97,7,52,26,26,5
23-10-2023,Quicksilver,1,986,534,595,147,448,52,10,18,1,17,0
23-10-2023,Discovery,2,427,311,279,125,154,75,44,64,31,33,3
23-10-2023,Mustangs,3,143,53,66,14,52,69,12,65,17,48,5
23-11-2021,Quicksilver,2,481,157,168,118,50,57,45,25,0,25,2
23-11-2021,PrimeSeven,3,922,563,278,223,55,58,35,42,15,27,4
23-11-2021,BitterLaser,3,727,606,503,335,168,64,28,29,25,4,2
23-11-2021,PrimeSeven,3,223,4,27,18,9,67,33,53,45,8,0
23-11-2021,ImpactTraining,1,853,294,518,343,175,57,40,34,3,31,2
23-11-2021,BitterLaser,3,416,348,312,276,36,82,13,26,8,18,0
23-11-2021,ImpactTraining,1,827,720,288,170,118,64,17,48,37,11,4
23-11-2021,PrimeSeven,3,579,284,365,234,131,90,33,55,39,16,4
23-11-2022,BitterLaser,2,471,397,365,358,7,78,14,30,26,4,2
23-11-2022,Honeycomb,1,167,113,110,107,3,53,46,29,18,11,2
23-11-2022,Quicksilver,2,208,98,2,0,2,65,51,3,0,3,0
23-11-2022,Aurora,1,359,64,171,155,16,82,81,44,8,36,5
23-11-2022,ImpactTraining,1,489,51,189,67,122,57,52,55,46,9,4
23-11-2022,Quicksilver,1,772,676,742,417,325,65,4,51,35,16,3
23-11-2022,ImpactTraining,2,143,117,77,56,21,99,53,5,4,1,0
23-11-2022,PrimeSeven,1,996,23,784,590,194,70,69,54,6,48,0
23-11-2022,ImpactTraining,2,933,682,878,80,798,93,88,92,36,56,6
23-11-2022,Mustangs,2,622,460,531,137,394,98,12,36,11,25,1
23-11-2022,Quicksilver,1,480,279,175,171,4,81,14,43,27,16,5
23-11-2023,Discovery,2,943,184,529,68,461,62,32,56,45,11,3
23-11-2023,Mustangs,3,950,206,837,448,389,96,76,95,56,39,10
23-11-2023,PrimeSeven,1,322,303,268,89,179,72,10,25,11,14,1
23-11-2023,Discovery,2,122,111,55,22,33,62,29,16,0,16,1
23-11-2023,PrimeSeven,3,424,300,154,96,58,73,27,42,22,20,0
23-11-2023,Mustangs,1,895,202,543,125,418,97,28,93,49,44,11
23-11-2023,BitterLaser,1,249,224,45,44,1,55,36,1,0,1,0
23-11-2023,CelestialInterface,1,598,221,469,110,359,58,46,40,17,23,3
23-12-2021,Honeycomb,3,439,333,85,63,22,99,0,78,64,14,9
23-12-2021,GrayPanthers,2,937,632,229,175,54,60,10,20,15,5,0
23-12-2021,Honeycomb,3,153,129,66,0,66,60,35,13,12,1,0
23-12-2021,CelestialInterface,2,909,848,438,435,3,50,37,8,4,4,0
23-12-2021,ImpactTraining,2,211,108,90,57,33,63,21,52,2,50,6
23-12-2021,Aurora,1,849,223,199,12,187,90,0,50,18,32,1
23-12-2021,ImpactTraining,3,226,202,66,23,43,86,23,16,10,6,1
23-12-2021,Aurora,1,692,634,476,37,439,91,49,66,32,34,8
23-12-2021,GrayPanthers,3,969,156,807,376,431,74,18,2,0,2,0
23-12-2021,Honeycomb,1,552,158,56,4,52,56,53,17,14,3,1
23-12-2021,GrayPanthers,2,692,431,407,266,141,57,8,46,9,37,0
23-12-2021,Quicksilver,2,133,67,20,6,14,69,32,3,0,3,0
23-12-2022,Discovery,3,779,395,461,412,49,87,64,55,45,10,6
23-12-2022,Aurora,2,588,8,52,14,38,57,23,40,10,30,0
23-12-2022,PrimeSeven,3,231,221,78,33,45,66,48,21,6,15,2
23-12-2022,GrayPanthers,3,582,457,380,17,363,85,40,49,38,11,5
23-12-2022,BitterLaser,3,497,118,135,46,89,87,80,9,1,8,0
23-12-2022,GrayPanthers,1,240,69,238,163,75,78,8,73,2,71,3
23-12-2022,Mustangs,3,122,49,92,15,77,68,35,6,0,6,0
23-12-2022,Quicksilver,1,463,462,150,17,133,54,25,31,4,27,0
23-12-2023,Quicksilver,3,818,330,390,20,370,81,46,5,3,2,0
23-12-2023,Honeycomb,3,943,612,6,3,3,60,51,4,0,4,0
23-12-2023,BitterLaser,2,929,157,907,248,659,87,5,82,46,36,6
23-12-2023,Mustangs,1,311,252,60,31,29,54,16,29,18,11,2
23-12-2023,Mustangs,2,403,128,77,57,20,70,64,46,26,20,0
23-12-2023,GrayPanthers,2,546,347,402,208,194,74,24,34,12,22,2
23-12-2023,Mustangs,2,476,170,188,176,12,69,40,24,22,2,2
23-12-2023,Mustangs,2,654,138,239,95,144,57,42,35,8,27,1
23-12-2023,Quicksilver,1,116,106,14,12,2,96,21,23,12,11,2
23-12-2023,Quicksilver,3,771,434,172,47,125,81,60,44,19,25,4
23-12-2023,Aurora,3,589,191,154,121,33,99,9,74,70,4,0
24-01-2021,Discovery,3,499,343,358,215,143,65,20,57,17,40,5
24-01-2021,Honeycomb,2,474,292,16,4,12,73,2,51,45,6,6
24-01-2021,Honeycomb,1,500,298,349,13,336,95,42,85,70,15,7
24-01-2021,Discovery,2,734,326,421,27,394,98,84,50,7,43,4
24-01-2021,Quicksilver,3,430,281,353,56,297,67,49,7,3,4,0
24-01-2021,CelestialInterface,2,695,227,88,50,38,87,32,23,2,21,1
24-01-2021,Quicksilver,2,940,227,27,4,23,73,0,62,51,11,4
24-01-2021,GrayPanthers,3,967,348,600,544,56,52,3,30,22,8,2
24-01-2021,Quicksilver,1,679,241,4,3,1,100,19,44,28,16,5
24-01-2022,PrimeSeven,2,873,63,467,334,133,61,30,16,9,7,1
24-01-2022,Mustangs,3,378,195,73,54,19,54,25,27,16,11,2
24-01-2022,Mustangs,3,714,304,46,35,11,62,22,46,15,31,4
24-01-2022,CelestialInterface,1,673,9,535,238,297,89,31,67,30,37,9
24-01-2022,Discovery,1,108,2,22,5,17,78,55,61,34,27,0
24-01-2022,Quicksilver,2,818,381,656,302,354,90,71,78,17,61,9
24-01-2022,Aurora,1,149,29,129,80,49,56,24,27,4,23,3
24-01-2022,PrimeSeven,2,882,585,345,187,158,81,77,32,30,2,1
24-01-2022,BitterLaser,3,669,296,491,432,59,73,62,8,1,7,0
24-01-2022,Aurora,1,793,460,699,275,424,71,37,49,1,48,5
24-01-2022,PrimeSeven,2,117,112,79,12,67,62,17,54,19,35,3
24-01-2023,Quicksilver,1,675,328,105,21,84,91,62,54,25,29,6
24-01-2023,CelestialInterface,1,974,27,812,292,520,55,45,26,3,23,1
24-01-2023,CelestialInterface,3,501,292,340,195,145,92,69,16,0,16,1
24-01-2023,ImpactTraining,2,373,278,205,136,69,95,91,27,0,27,3
24-01-2023,CelestialInterface,2,839,571,577,551,26,70,15,69,16,53,2
24-01-2023,CelestialInterface,1,758,68,659,53,606,83,22,75,16,59,5
24-01-2023,BitterLaser,3,899,212,289,78,211,94,55,90,14,76,9
24-01-2023,CelestialInterface,1,577,502,71,67,4,78,69,22,16,6,1
24-01-2023,GrayPanthers,3,132,81,65,26,39,81,16,39,9,30,1
24-01-2023,ImpactTraining,2,679,643,509,20,489,71,31,59,52,7,6
24-01-2023,ImpactTraining,3,620,487,250,178,72,100,26,17,11,6,1
24-01-2023,Mustangs,3,762,366,754,268,486,50,27,26,13,13,2
24-02-2021,Mustangs,3,841,117,150,63,87,60,41,29,7,22,1
24-02-2021,PrimeSeven,2,464,313,69,34,35,72,68,2,1,1,0
24-02-2021,BitterLaser,1,382,88,259,240,19,100,72,90,9,81,0
24-02-2021,CelestialInterface,1,200,191,189,101,88,53,31,25,4,21,0
24-02-2021,Quicksilver,3,186,151,28,8,20,99,44,73,29,44,2
24-02-2021,ImpactTraining,3,850,824,332,165,167,87,58,83,22,61,2
24-02-2022,ImpactTraining,3,456,420,144,19,125,69,6,44,28,16,3
24-02-2022,Quicksilver,2,939,211,925,659,266,61,60,42,19,23,5
24-02-2022,Mustangs,2,483,198,163,33,130,59,41,17,1,16,0
24-02-2022,Aurora,3,717,213,89,75,14,80,52,6,0,6,0
24-02-2022,CelestialInterface,3,546,259,277,233,44,88,28,48,24,24,4
24-02-2022,CelestialInterface,1,170,73,152,12,140,79,53,44,11,33,1
24-02-2022,GrayPanthers,3,605,294,315,134,181,98,69,51,7,44,1
24-02-2022,Discovery,3,552,143,113,95,18,56,38,5,4,1,0
24-02-2022,GrayPanthers,1,251,133,135,53,82,63,62,8,3,5,0
24-02-2022,CelestialInterface,3,957,681,740,595,145,92,34,48,12,36,3
24-02-2022,PrimeSeven,3,790,637,632,174,458,53,37,37,5,32,1
24-02-2023,GrayPanthers,3,816,150,770,509,261,73,9,58,43,15,3
24-02-2023,GrayPanthers,1,314,130,153,75,78,78,22,34,10,24,0
24-02-2023,Mustangs,2,264,133,262,84,178,50,8,31,20,11,2
24-02-2023,ImpactTraining,1,149,4,107,105,2,67,23,20,2,18,0
24-02-2023,CelestialInterface,3,972,740,436,231,205,59,12,3,0,3,0
24-02-2023,PrimeSeven,2,649,385,268,45,223,60,22,13,6,7,0
24-02-2023,PrimeSeven,1,919,876,490,292,198,77,30,15,8,7,0
24-02-2023,Mustangs,2,276,141,123,102,21,74,60,37,29,8,3
24-02-2023,Mustangs,1,690,178,684,397,287,84,51,47,40,7,5
24-02-2023,ImpactTraining,2,197,110,74,15,59,100,58,72,57,15,5
24-02-2023,Aurora,1,239,161,89,68,21,84,33,51,17,34,5
24-02-2023,Quicksilver,1,625,567,277,215,62,90,18,17,4,13,1
24-02-2023,Aurora,2,775,332,78,53,25,55,7,52,21,31,6
24-02-2023,CelestialInterface,1,177,58,44,2,42,75,66,45,10,35,4
24-03-2021,Discovery,1,933,561,382,217,165,57,23,9,2,7,0
24-03-2021,GrayPanthers,3,257,19,131,10,121,81,11,75,68,7,9
24-03-2021,Quicksilver,2,131,83,126,117,9,57,22,11,9,2,0
24-03-2021,Mustangs,1,876,399,485,421,64,100,61,23,0,23,1
24-03-2021,GrayPanthers,2,515,318,139,108,31,50,32,27,24,3,2
24-03-2021,GrayPanthers,1,424,348,189,165,24,92,2,91,22,69,6
24-03-2021,PrimeSeven,2,724,199,96,40,56,50,11,9,6,3,0
24-03-2021,Quicksilver,2,348,129,140,36,104,62,32,33,17,16,3
24-03-2022,Quicksilver,2,440,350,129,79,50,90,34,49,37,12,4
24-03-2022,Mustangs,3,728,256,661,459,202,92,7,87,85,2,1
24-03-2022,Mustangs,2,619,132,558,144,414,98,70,39,7,32,0
24-03-2022,BitterLaser,3,646,605,308,307,1,64,30,34,24,10,4
24-03-2022,BitterLaser,2,962,895,555,387,168,70,5,48,30,18,3
24-03-2022,Honeycomb,3,407,259,102,84,18,96,34,39,17,22,1
24-03-2022,Honeycomb,1,240,226,68,16,52,72,25,30,24,6,2
24-03-2022,Mustangs,2,985,972,497,419,78,89,11,9,6,3,0
24-03-2022,Honeycomb,3,737,422,469,308,161,54,48,23,3,20,2
24-03-2022,Aurora,1,506,232,163,132,31,84,25,76,49,27,4
24-03-2023,Honeycomb,1,585,306,170,91,79,87,22,85,11,74,0
24-03-2023,Aurora,1,825,767,692,326,366,61,37,38,25,13,4
24-03-2023,Quicksilver,3,498,23,297,247,50,97,18,2,0,2,0
24-03-2023,PrimeSeven,3,924,726,239,89,150,82,55,15,8,7,0
24-03-2023,Honeycomb,3,355,16,302,65,237,78,72,59,6,53,1
24-03-2023,ImpactTraining,2,628,377,530,133,397,65,63,51,40,11,0
24-04-2021,BitterLaser,2,286,59,132,59,73,61,56,56,8,48,2
24-04-2021,Mustangs,2,357,60,342,96,246,99,98,31,26,5,1
24-04-2021,BitterLaser,3,308,41,39,23,16,70,13,22,14,8,1
24-04-2021,CelestialInterface,1,386,160,372,90,282,95,21,52,21,31,0
24-04-2021,ImpactTraining,2,335,185,26,9,17,90,88,74,52,22,6
24-04-2021,Honeycomb,2,208,1,4,2,2,65,26,42,18,24,4
24-04-2021,PrimeSeven,1,547,504,210,57,153,85,29,53,33,20,6
24-04-2021,Aurora,3,102,76,84,52,32,54,49,43,15,28,5
24-04-2021,Honeycomb,2,737,249,554,405,149,95,81,62,57,5,2
24-04-2021,ImpactTraining,1,855,451,28,4,24,70,45,51,33,18,4
24-04-2021,PrimeSeven,3,147,83,109,20,89,63,4,16,15,1,0
24-04-2022,GrayPanthers,2,909,536,600,163,437,99,59,82,33,49,11
24-04-2022,Quicksilver,2,122,21,82,68,14,100,65,52,9,43,4
24-04-2022,GrayPanthers,2,283,207,240,33,207,52,21,25,13,12,2
24-04-2022,Mustangs,2,597,546,434,239,195,50,14,35,7,28,4
24-04-2022,Quicksilver,1,203,99,184,23,161,100,75,84,64,20,4
24-04-2022,Honeycomb,1,465,403,459,104,355,72,60,35,23,12,2
24-04-2022,Discovery,2,977,381,336,208,128,71,28,61,9,52,8
24-04-2022,ImpactTraining,3,159,81,83,19,64,66,18,22,5,17,1
24-04-2022,Quicksilver,3,450,74,393,154,239,65,62,40,12,28,4
24-04-2022,Discovery,3,508,222,44,40,4,92,8,58,45,13,6
24-04-2023,Quicksilver,1,293,185,104,55,49,98,71,97,27,70,11
24-04-2023,GrayPanthers,1,361,147,149,124,25,55,21,23,0,23,2
24-04-2023,CelestialInterface,3,899,123,583,579,4,82,3,27,17,10,0
24-04-2023,Quicksilver,2,516,293,129,94,35,97,78,2,1,1,0
24-04-2023,Quicksilver,1,579,246,183,108,75,73,17,4,0,4,0
24-04-2023,Aurora,1,751,600,405,324,81,58,4,25,16,9,1
24-04-2023,Honeycomb,1,251,42,173,89,84,69,59,22,17,5,0
24-04-2023,ImpactTraining,1,996,444,506,221,285,66,11,0,0,0,0
24-04-2023,Aurora,2,546,70,83,25,58,73,3,32,29,3,1
24-04-2023,Quicksilver,1,661,642,656,18,638,81,14,52,39,13,0
24-04-2023,BitterLaser,2,997,766,258,67,191,90,21,67,10,57,1
24-04-2023,Aurora,1,641,33,609,475,134,86,56,2,0,2,0
24-04-2023,Mustangs,3,793,770,304,263,41,78,61,33,23,10,3
24-04-2023,Discovery,1,593,110,496,157,339,50,13,18,5,13,0
24-04-2023,Discovery,3,534,427,185,123,62,85,84,60,8,52,2
24-05-2021,ImpactTraining,3,297,69,176,1,175,77,73,29,27,2,0
24-05-2021,Honeycomb,2,577,193,506,117,389,59,23,56,28,28,1
24-05-2021,Discovery,1,774,501,704,161,543,96,7,40,11,29,0
24-05-2021,ImpactTraining,2,924,915,414,321,93,53,10,19,3,16,1
24-05-2021,ImpactTraining,3,533,344,182,168,14,51,2,33,3,30,3
24-05-2021,Mustangs,2,666,177,647,438,209,84,2,66,22,44,6
24-05-2021,Mustangs,1,829,6,15,7,8,96,91,67,45,22,8
24-05-2021,ImpactTraining,3,590,550,136,59,77,82,42,9,2,7,0
24-05-2022,PrimeSeven,2,240,96,99,16,83,100,70,5,0,5,0
24-05-2022,Discovery,1,878,100,378,59,319,60,9,41,27,14,5
24-05-2022,Honeycomb,2,328,197,107,0,107,58,26,50,0,50,2
24-05-2022,CelestialInterface,1,127,18,103,8,95,63,34,29,26,3,1
24-05-2022,ImpactTraining,2,784,624,30,22,8,68,5,14,12,2,1
24-05-2022,Discovery,2,130,99,86,42,44,87,71,59,52,7,6
24-05-2022,GrayPanthers,2,373,6,21,1,20,98,60,65,18,47,6
24-05-2022,CelestialInterface,2,608,433,321,235,86,72,24,63,31,32,8
24-05-2022,BitterLaser,2,824,398,482,475,7,55,13,18,0,18,0
24-05-2022,GrayPanthers,2,808,621,413,215,198,96,57,8,6,2,0
24-05-2023,Discovery,3,675,305,447,400,47,51,24,8,3,5,0
24-05-2023,ImpactTraining,2,630,473,423,290,133,51,38,2,1,1,0
24-05-2023,Aurora,2,861,544,822,548,274,70,12,65,56,9,1
24-05-2023,CelestialInterface,3,659,593,81,5,76,50,34,24,15,9,2
24-05-2023,PrimeSeven,1,749,26,252,201,51,85,79,48,27,21,3
24-05-2023,CelestialInterface,1,630,414,587,426,161,83,66,34,17,17,1
24-05-2023,CelestialInterface,1,994,11,618,75,543,65,23,12,9,3,0
24-05-2023,Discovery,1,528,416,184,126,58,68,31,63,9,54,7
24-05-2023,ImpactTraining,1,452,407,114,44,70,81,47,45,11,34,3
24-05-2023,GrayPanthers,3,525,481,112,12,100,97,47,43,33,10,0
24-05-2023,Quicksilver,3,111,22,39,5,34,53,24,19,10,9,0
24-06-2021,Aurora,2,588,389,541,427,114,85,53,18,0,18,1
24-06-2021,Aurora,3,882,144,535,265,270,96,59,4,0,4,0
24-06-2021,PrimeSeven,1,483,146,326,295,31,62,9,57,32,25,7
24-06-2021,Honeycomb,2,101,89,100,27,73,99,34,58,24,34,7
24-06-2021,BitterLaser,1,549,435,114,100,14,62,17,13,0,13,0
24-06-2021,BitterLaser,3,765,556,192,148,44,79,35,17,11,6,1
24-06-2021,CelestialInterface,1,322,88,219,157,62,50,23,28,21,7,0
24-06-2021,BitterLaser,3,566,391,551,433,118,65,2,7,0,7,0
24-06-2021,PrimeSeven,2,806,103,204,94,110,85,59,61,6,55,1
24-06-2021,Quicksilver,2,683,467,543,81,462,85,24,35,11,24,1
24-06-2021,ImpactTraining,1,926,292,32,11,21,77,54,6,4,2,0
24-06-2022,PrimeSeven,1,833,475,358,6,352,53,47,17,10,7,1
24-06-2022,PrimeSeven,3,861,394,505,352,153,74,4,1,0,1,0
24-06-2022,CelestialInterface,3,351,43,266,53,213,83,44,37,26,11,1
24-06-2022,Quicksilver,2,279,93,145,107,38,98,59,71,2,69,9
24-06-2022,Aurora,2,690,487,125,65,60,52,40,34,1,33,0
24-06-2022,BitterLaser,2,886,761,242,175,67,99,10,18,10,8,0
24-06-2022,Aurora,1,951,577,311,171,140,59,39,36,4,32,1
24-06-2022,Discovery,1,336,293,92,45,47,90,76,21,1,20,1
24-06-2022,PrimeSeven,1,234,221,191,16,175,68,13,63,23,40,1
24-06-2022,CelestialInterface,2,845,315,825,816,9,92,77,44,1,43,1
24-06-2023,Quicksilver,1,199,51,169,90,79,72,11,31,12,19,3
24-06-2023,Quicksilver,2,648,403,367,281,86,85,22,12,2,10,0
24-06-2023,Mustangs,1,783,259,282,178,104,55,29,17,15,2,0
24-06-2023,ImpactTraining,3,582,155,401,139,262,73,37,30,9,21,1
24-06-2023,Discovery,3,615,187,277,203,74,87,43,76,30,46,4
24-06-2023,PrimeSeven,2,977,569,761,538,223,69,50,41,6,35,3
24-06-2023,Aurora,2,982,138,420,296,124,76,53,45,29,16,5
24-06-2023,BitterLaser,1,746,116,168,74,94,62,36,59,45,14,4
24-06-2023,PrimeSeven,2,906,312,201,55,146,55,23,7,5,2,0
24-07-2021,CelestialInterface,1,737,311,450,304,146,51,50,24,20,4,2
24-07-2021,GrayPanthers,3,191,92,100,45,55,73,70,21,8,13,0
24-07-2021,ImpactTraining,3,231,135,33,7,26,86,32,53,2,51,3
24-07-2021,Honeycomb,2,119,41,26,15,11,51,23,12,2,10,0
24-07-2021,GrayPanthers,2,208,135,7,0,7,75,31,38,37,1,2
24-07-2021,ImpactTraining,1,344,84,279,89,190,100,36,30,7,23,0
24-07-2021,Mustangs,2,507,48,93,80,13,100,9,21,10,11,1
24-07-2021,ImpactTraining,3,282,15,250,225,25,94,20,56,25,31,5
24-07-2022,PrimeSeven,3,259,45,150,109,41,99,88,49,9,40,4
24-07-2022,Honeycomb,2,313,98,77,37,40,81,36,67,33,34,5
24-07-2022,Discovery,3,181,134,1,0,1,99,16,57,49,8,5
24-07-2022,BitterLaser,2,985,491,758,676,82,50,31,49,7,42,6
24-07-2022,BitterLaser,1,213,6,62,25,37,92,40,39,10,29,3
24-07-2022,Quicksilver,1,266,3,198,20,178,78,41,49,37,12,5
24-07-2022,Discovery,3,168,21,166,87,79,56,24,23,3,20,0
24-07-2022,Aurora,2,402,299,395,362,33,87,21,23,4,19,2
24-07-2022,Honeycomb,2,890,476,370,131,239,63,8,45,25,20,2
24-07-2022,Quicksilver,2,195,134,184,113,71,87,49,72,4,68,2
24-07-2022,Quicksilver,1,516,73,15,5,10,88,85,25,21,4,1
24-07-2023,Aurora,2,528,86,152,83,69,56,34,51,9,42,6
24-07-2023,PrimeSeven,1,838,387,45,7,38,84,7,64,30,34,0
24-07-2023,CelestialInterface,1,977,788,742,606,136,92,49,30,6,24,3
24-07-2023,PrimeSeven,3,578,382,32,15,17,69,4,36,21,15,3
24-07-2023,Aurora,3,931,898,205,150,55,65,44,60,17,43,7
24-07-2023,Discovery,1,249,154,61,13,48,65,45,35,15,20,1
24-07-2023,GrayPanthers,3,733,260,473,472,1,85,27,42,3,39,0
24-08-2021,Honeycomb,1,548,486,5,3,2,54,52,34,33,1,0
24-08-2021,Mustangs,2,452,63,424,199,225,92,46,32,28,4,3
24-08-2021,Quicksilver,2,595,163,95,26,69,86,71,8,2,6,0
24-08-2021,Aurora,2,320,302,213,120,93,94,51,57,44,13,4
24-08-2021,CelestialInterface,2,443,227,71,59,12,62,54,49,16,33,6
24-08-2021,GrayPanthers,1,453,396,313,304,9,59,23,38,37,1,4
24-08-2021,Mustangs,1,857,236,397,185,212,60,29,2,1,1,0
24-08-2022,GrayPanthers,1,243,133,185,101,84,97,64,36,24,12,4
24-08-2022,ImpactTraining,2,883,582,410,295,115,95,10,27,1,26,0
24-08-2022,GrayPanthers,2,613,53,385,136,249,74,28,47,31,16,4
24-08-2022,Discovery,3,131,81,80,67,13,55,5,53,20,33,5
24-08-2022,ImpactTraining,2,889,633,20,12,8,61,41,5,0,5,0
24-08-2022,GrayPanthers,3,530,306,301,12,289,75,70,51,13,38,4
24-08-2022,CelestialInterface,3,622,336,341,92,249,77,20,66,61,5,6
24-08-2022,Honeycomb,3,908,563,48,41,7,83,68,64,16,48,0
24-08-2022,CelestialInterface,2,573,235,37,22,15,97,56,57,35,22,2
24-08-2022,Mustangs,3,838,527,525,321,204,50,32,21,14,7,2
24-08-2022,GrayPanthers,3,579,101,72,66,6,54,5,9,2,7,0
24-08-2022,Aurora,3,242,16,228,168,60,95,62,67,65,2,5
24-08-2023,BitterLaser,1,793,670,178,76,102,99,32,49,46,3,1
24-08-2023,Mustangs,3,613,6,77,63,14,70,48,52,26,26,3
24-08-2023,ImpactTraining,1,706,444,475,457,18,99,75,21,12,9,2
24-08-2023,Mustangs,3,609,172,25,21,4,83,43,42,9,33,1
24-08-2023,Discovery,3,315,96,272,94,178,52,40,50,27,23,6
24-08-2023,Aurora,3,343,263,332,76,256,74,59,4,0,4,0
24-08-2023,CelestialInterface,3,547,74,115,43,72,62,50,49,20,29,5
24-08-2023,BitterLaser,1,329,324,320,85,235,71,21,46,39,7,1
24-08-2023,Aurora,2,114,82,60,2,58,67,23,46,29,17,1
24-09-2021,Discovery,3,260,255,171,142,29,79,7,56,30,26,0
24-09-2021,BitterLaser,3,325,16,253,187,66,64,29,0,0,0,0
24-09-2021,Quicksilver,2,825,154,785,117,668,80,50,3,1,2,0
24-09-2021,PrimeSeven,3,251,222,185,106,79,61,54,26,14,12,2
24-09-2021,Quicksilver,3,735,39,253,246,7,53,1,14,2,12,1
24-09-2021,GrayPanthers,2,849,303,23,5,18,91,10,16,13,3,1
24-09-2021,Mustangs,2,715,617,503,50,453,67,26,23,15,8,2
24-09-2021,GrayPanthers,1,693,351,192,92,100,97,60,70,50,20,2
24-09-2021,Mustangs,1,387,296,278,250,28,52,38,49,42,7,1
24-09-2021,Quicksilver,1,857,143,672,295,377,67,42,33,32,1,2
24-09-2022,Discovery,1,726,109,470,12,458,85,61,76,57,19,3
24-09-2022,ImpactTraining,2,285,233,220,125,95,81,3,5,2,3,0
24-09-2022,Discovery,1,919,804,905,835,70,93,55,86,39,47,2
24-09-2022,Honeycomb,2,525,219,524,477,47,71,33,50,17,33,6
24-09-2022,PrimeSeven,2,444,305,406,190,216,83,50,60,29,31,3
24-09-2022,Discovery,3,963,944,652,362,290,67,2,16,15,1,0
24-09-2022,GrayPanthers,2,944,74,271,267,4,63,3,16,2,14,1
24-09-2022,Mustangs,3,299,142,140,80,60,72,37,17,5,12,0
24-09-2022,GrayPanthers,1,202,114,11,2,9,92,21,73,31,42,2
24-09-2022,ImpactTraining,3,258,122,66,7,59,86,70,34,26,8,4
24-09-2023,Aurora,3,302,285,183,182,1,83,48,77,1,76,9
24-09-2023,Discovery,3,466,143,302,211,91,64,32,51,40,11,1
24-09-2023,Discovery,3,619,210,158,99,59,53,30,0,0,0,0
24-09-2023,Discovery,3,116,70,89,65,24,87,30,74,22,52,6
24-09-2023,GrayPanthers,2,890,263,378,27,351,56,44,17,16,1,1
24-09-2023,Aurora,1,738,256,333,253,80,75,42,15,10,5,1
24-10-2021,GrayPanthers,3,114,38,85,32,53,57,12,3,1,2,0
24-10-2021,Mustangs,3,969,697,288,221,67,81,66,72,14,58,9
24-10-2021,GrayPanthers,1,446,73,75,23,52,81,1,32,21,11,0
24-10-2021,Honeycomb,3,584,171,83,10,73,77,62,18,15,3,0
24-10-2021,Aurora,3,513,192,190,68,122,62,56,32,1,31,3
24-10-2021,CelestialInterface,3,177,138,21,3,18,95,22,23,6,17,0
24-10-2021,GrayPanthers,1,345,46,224,169,55,59,44,26,9,17,1
24-10-2021,Honeycomb,3,176,120,4,0,4,59,24,21,16,5,1
24-10-2021,Mustangs,3,227,15,4,3,1,58,22,14,12,2,0
24-10-2021,Honeycomb,2,202,3,37,27,10,65,14,16,2,14,1
24-10-2021,ImpactTraining,1,499,154,30,12,18,98,22,89,52,37,5
24-10-2021,PrimeSeven,2,562,383,44,30,14,74,22,19,17,2,0
24-10-2021,Quicksilver,2,464,58,432,382,50,78,26,50,30,20,3
24-10-2021,Quicksilver,1,414,138,187,96,91,66,40,11,2,9,0
24-10-2021,Honeycomb,1,181,158,38,24,14,71,24,13,9,4,0
24-10-2022,Discovery,1,440,181,425,91,334,90,46,35,3,32,0
24-10-2022,CelestialInterface,3,822,316,729,329,400,92,14,1,0,1,0
24-10-2022,PrimeSeven,1,151,20,118,6,112,94,36,15,1,14,1
24-10-2022,ImpactTraining,3,182,14,47,26,21,78,72,74,12,62,0
24-10-2022,Discovery,1,643,220,331,301,30,95,25,49,29,20,0
24-10-2023,Quicksilver,2,267,45,265,1,264,52,17,18,2,16,0
24-10-2023,Aurora,3,469,423,236,57,179,71,64,59,34,25,1
24-10-2023,CelestialInterface,2,446,318,168,69,99,74,36,25,1,24,0
24-10-2023,ImpactTraining,1,327,154,308,272,36,96,90,22,1,21,2
24-10-2023,Mustangs,1,167,155,143,75,68,68,47,44,8,36,5
24-10-2023,Mustangs,1,807,152,579,430,149,66,53,45,41,4,0
24-10-2023,ImpactTraining,3,705,459,516,180,336,68,22,45,6,39,0
24-10-2023,Quicksilver,2,562,211,512,11,501,91,15,13,10,3,0
24-10-2023,Discovery,1,876,43,497,271,226,75,1,56,21,35,6
24-11-2021,CelestialInterface,1,808,234,304,286,18,53,42,15,10,5,0
24-11-2021,Aurora,3,470,174,342,109,233,89,46,21,0,21,0
24-11-2021,Quicksilver,3,297,15,58,48,10,54,32,50,26,24,3
24-11-2021,Aurora,1,672,225,111,19,92,94,9,22,20,2,0
24-11-2021,Quicksilver,1,857,825,826,768,58,76,25,45,3,42,3
24-11-2021,PrimeSeven,1,449,379,56,22,34,74,6,13,6,7,0
24-11-2021,Discovery,2,702,608,464,192,272,83,29,16,8,8,0
24-11-2022,Aurora,2,178,176,118,106,12,61,26,4,2,2,0
24-11-2022,GrayPanthers,2,537,357,247,244,3,75,34,16,1,15,0
24-11-2022,Quicksilver,3,653,584,12,3,9,64,30,12,3,9,0
24-11-2022,BitterLaser,2,533,227,15,14,1,92,24,64,8,56,1
24-11-2023,PrimeSeven,1,572,62,538,261,277,55,1,13,8,5,0
24-11-2023,BitterLaser,1,943,145,509,75,434,56,22,25,18,7,0
24-11-2023,Aurora,1,221,15,8,1,7,81,56,73,27,46,7
24-11-2023,PrimeSeven,1,659,195,255,67,188,93,0,0,0,0,0
24-11-2023,GrayPanthers,3,798,599,765,274,491,71,0,53,4,49,2
24-11-2023,ImpactTraining,3,670,596,2,0,2,64,14,12,2,10,0
24-11-2023,GrayPanthers,1,390,342,173,25,148,83,70,6,2,4,0
24-12-2021,Mustangs,2,360,278,262,40,222,63,30,50,43,7,5
24-12-2021,CelestialInterface,3,194,21,65,8,57,62,55,61,1,60,5
24-12-2021,Quicksilver,2,947,489,113,55,58,69,13,8,4,4,0
24-12-2021,CelestialInterface,2,310,52,214,117,97,72,40,13,11,2,0
24-12-2021,GrayPanthers,3,799,354,392,201,191,76,29,19,11,8,0
24-12-2021,Quicksilver,2,650,342,602,43,559,91,37,30,2,28,2
24-12-2021,GrayPanthers,3,298,250,63,28,35,94,29,25,2,23,1
24-12-2021,GrayPanthers,2,983,380,969,362,607,51,20,2,1,1,0
24-12-2021,Quicksilver,2,419,88,369,59,310,60,2,27,11,16,3
24-12-2021,Mustangs,3,878,608,243,85,158,56,40,28,16,12,3
24-12-2021,Discovery,3,598,73,19,12,7,90,82,89,12,77,0
24-12-2021,ImpactTraining,3,504,318,410,75,335,69,7,65,37,28,7
24-12-2021,Honeycomb,1,372,170,51,13,38,85,42,50,43,7,6
24-12-2021,Mustangs,1,841,601,749,478,271,95,94,33,13,20,2
24-12-2021,Quicksilver,3,617,307,33,32,1,95,41,26,16,10,0
24-12-2021,GrayPanthers,3,700,339,651,160,491,99,8,89,32,57,10
24-12-2022,Aurora,1,503,79,97,89,8,84,20,59,56,3,7
24-12-2022,CelestialInterface,3,816,646,472,395,77,52,40,30,23,7,3
24-12-2022,CelestialInterface,1,660,485,50,40,10,99,12,87,50,37,6
24-12-2022,Honeycomb,3,159,19,150,106,44,74,19,14,13,1,0
24-12-2022,Honeycomb,3,976,111,737,330,407,85,77,77,61,16,8
24-12-2022,Honeycomb,1,654,579,481,474,7,68,22,24,15,9,1
24-12-2022,Quicksilver,1,217,70,97,35,62,79,63,57,20,37,6
24-12-2022,ImpactTraining,2,225,53,119,98,21,88,80,86,4,82,6
24-12-2022,Honeycomb,1,892,755,47,40,7,95,74,46,5,41,5
24-12-2022,Mustangs,2,821,272,207,197,10,67,42,5,3,2,0
24-12-2022,GrayPanthers,1,547,60,134,68,66,75,33,43,12,31,2
24-12-2022,GrayPanthers,2,498,426,290,160,130,56,33,48,42,6,1
24-12-2022,Quicksilver,2,273,219,247,229,18,69,56,42,19,23,5
24-12-2023,BitterLaser,1,360,166,266,166,100,64,17,10,6,4,0
24-12-2023,PrimeSeven,2,948,802,143,98,45,93,72,3,0,3,0
24-12-2023,GrayPanthers,3,741,323,190,183,7,56,44,28,2,26,3
24-12-2023,Mustangs,2,555,139,436,414,22,94,90,20,12,8,2
24-12-2023,CelestialInterface,3,425,67,57,31,26,100,30,50,25,25,4
24-12-2023,ImpactTraining,1,612,241,604,239,365,52,11,11,0,11,0
24-12-2023,Quicksilver,3,446,67,8,7,1,99,58,3,2,1,0
24-12-2023,Discovery,1,621,50,444,47,397,86,76,19,7,12,1
24-12-2023,GrayPanthers,3,325,147,17,13,4,51,25,41,39,2,3
24-12-2023,Discovery,3,158,76,85,68,17,79,64,32,25,7,3
24-12-2023,Honeycomb,1,818,534,608,244,364,63,43,10,0,10,0
24-12-2023,Aurora,3,890,763,13,1,12,72,55,45,38,7,3
24-12-2023,Quicksilver,3,799,504,484,102,382,55,50,12,10,2,0
25-01-2021,Mustangs,2,218,104,8,5,3,95,0,70,20,50,3
25-01-2021,ImpactTraining,3,455,40,14,7,7,54,48,46,43,3,2
25-01-2021,GrayPanthers,2,425,54,390,278,112,76,12,36,27,9,1
25-01-2021,GrayPanthers,2,122,26,1,0,1,67,7,15,6,9,0
25-01-2021,Aurora,3,121,59,43,35,8,80,1,78,31,47,10
25-01-2021,Honeycomb,3,812,27,451,196,255,70,51,4,3,1,0
25-01-2021,CelestialInterface,2,116,63,99,92,7,57,29,38,15,23,1
25-01-2021,PrimeSeven,2,295,80,147,63,84,50,9,23,17,6,1
25-01-2021,Quicksilver,2,243,231,115,93,22,55,25,51,50,1,1
25-01-2021,PrimeSeven,3,746,2,313,79,234,68,5,66,36,30,1
25-01-2022,ImpactTraining,1,691,441,161,38,123,89,31,6,1,5,0
25-01-2022,ImpactTraining,3,825,654,554,25,529,94,8,81,7,74,8
25-01-2022,Honeycomb,2,514,321,245,111,134,85,5,48,38,10,0
25-01-2022,BitterLaser,2,748,200,431,208,223,96,25,62,2,60,8
25-01-2022,PrimeSeven,1,484,155,395,204,191,67,5,0,0,0,0
25-01-2022,Honeycomb,2,376,293,28,6,22,94,40,79,31,48,6
25-01-2022,GrayPanthers,1,221,31,101,45,56,74,22,3,0,3,0
25-01-2022,PrimeSeven,2,972,505,593,220,373,71,48,38,25,13,1
25-01-2023,Honeycomb,1,352,168,12,2,10,98,83,85,84,1,9
25-01-2023,Mustangs,3,301,154,37,27,10,90,18,64,53,11,1
25-01-2023,Mustangs,3,731,336,142,14,128,86,45,7,3,4,0
25-01-2023,Honeycomb,3,805,350,202,92,110,95,73,3,0,3,0
25-01-2023,CelestialInterface,1,442,317,12,11,1,55,5,13,4,9,0
25-01-2023,GrayPanthers,3,964,254,864,544,320,97,56,67,39,28,1
25-02-2021,Discovery,3,647,570,430,227,203,99,16,91,52,39,8
25-02-2021,ImpactTraining,2,483,158,74,0,74,69,10,41,40,1,5
25-02-2021,Aurora,1,972,764,585,487,98,74,7,30,23,7,2
25-02-2021,PrimeSeven,1,138,96,80,41,39,85,10,84,37,47,6
25-02-2022,CelestialInterface,3,502,11,145,129,16,73,46,21,6,15,2
25-02-2022,Aurora,3,793,201,471,105,366,96,51,48,7,41,6
25-02-2022,ImpactTraining,1,833,343,17,8,9,64,29,33,0,33,3
25-02-2022,BitterLaser,2,959,182,778,471,307,93,26,80,20,60,9
25-02-2022,ImpactTraining,2,634,397,128,109,19,60,17,37,1,36,4
25-02-2022,PrimeSeven,1,523,51,414,156,258,89,1,88,55,33,1
25-02-2022,Mustangs,1,583,366,412,71,341,84,23,30,6,24,1
25-02-2022,Discovery,3,274,168,85,54,31,56,1,21,10,11,0
25-02-2022,GrayPanthers,1,789,155,779,347,432,59,32,55,15,40,5
25-02-2022,Quicksilver,2,889,446,273,83,190,84,24,56,25,31,2
25-02-2022,Quicksilver,3,663,501,580,24,556,87,46,68,10,58,2
25-02-2022,Mustangs,1,718,584,632,316,316,100,27,89,47,42,7
25-02-2022,Mustangs,2,203,20,68,26,42,60,17,38,3,35,3
25-02-2022,BitterLaser,3,260,259,93,86,7,78,42,76,13,63,6
25-02-2022,PrimeSeven,2,498,135,419,402,17,73,42,34,17,17,0
25-02-2023,Aurora,1,549,222,86,26,60,68,26,7,4,3,0
25-02-2023,Honeycomb,2,756,477,437,27,410,85,7,28,19,9,3
25-02-2023,Mustangs,3,572,96,553,332,221,92,90,64,22,42,8
25-02-2023,CelestialInterface,1,473,454,350,223,127,90,67,12,1,11,0
25-02-2023,BitterLaser,3,641,369,265,84,181,63,8,11,5,6,0
25-02-2023,Aurora,1,545,60,535,506,29,91,10,86,51,35,4
25-02-2023,Mustangs,1,488,58,254,109,145,92,39,64,56,8,5
25-02-2023,Discovery,3,456,451,261,89,172,79,34,14,0,14,1
25-03-2021,ImpactTraining,3,299,23,115,102,13,67,28,65,38,27,5
25-03-2021,Discovery,2,514,5,300,120,180,65,63,59,47,12,6
25-03-2021,Honeycomb,3,814,25,359,83,276,70,15,6,4,2,0
25-03-2021,Mustangs,2,282,214,247,32,215,74,21,45,0,45,5
25-03-2021,Honeycomb,1,465,227,192,49,143,84,78,73,15,58,8
25-03-2021,Honeycomb,1,680,117,16,1,15,82,15,7,1,6,0
25-03-2021,Aurora,1,848,657,399,184,215,71,13,60,48,12,3
25-03-2022,ImpactTraining,1,872,152,188,102,86,97,11,85,69,16,0
25-03-2022,ImpactTraining,1,472,312,372,40,332,92,62,54,11,43,1
25-03-2022,Aurora,3,518,227,24,23,1,89,7,9,3,6,0
25-03-2022,GrayPanthers,2,998,645,753,538,215,52,27,44,24,20,1
25-03-2022,Quicksilver,3,777,279,429,141,288,67,64,11,0,11,0
25-03-2022,GrayPanthers,1,296,279,14,0,14,91,74,25,3,22,2
25-03-2022,Discovery,1,238,45,171,81,90,85,23,9,5,4,0
25-03-2022,Discovery,1,537,306,25,10,15,50,21,28,8,20,0
25-03-2022,GrayPanthers,2,902,612,862,425,437,79,61,65,42,23,0
25-03-2022,BitterLaser,3,453,169,60,54,6,85,74,12,9,3,0
25-03-2022,CelestialInterface,1,783,637,607,469,138,90,52,80,32,48,3
25-03-2023,BitterLaser,3,630,138,55,17,38,57,45,27,26,1,0
25-03-2023,Quicksilver,2,205,61,91,24,67,70,61,56,52,4,3
25-03-2023,Discovery,2,652,555,243,80,163,72,25,61,33,28,3
25-03-2023,PrimeSeven,3,101,100,82,31,51,65,56,54,17,37,1
25-03-2023,Discovery,3,829,635,336,4,332,98,95,7,2,5,0
25-03-2023,BitterLaser,3,526,451,325,60,265,50,33,22,12,10,1
25-03-2023,Discovery,2,425,0,84,12,72,63,60,48,2,46,2
25-03-2023,Quicksilver,1,326,141,4,0,4,67,19,14,3,11,1
25-03-2023,Aurora,2,214,120,199,181,18,92,17,59,39,20,1
25-03-2023,Honeycomb,2,904,551,737,473,264,56,22,14,5,9,0
25-03-2023,Mustangs,1,573,315,492,217,275,58,31,53,46,7,2
25-03-2023,GrayPanthers,2,231,196,93,18,75,63,15,8,0,8,0
25-03-2023,Discovery,1,697,614,385,196,189,61,3,20,4,16,1
25-03-2023,CelestialInterface,3,902,808,252,189,63,93,20,9,0,9,0
25-03-2023,Honeycomb,1,282,226,158,84,74,61,3,2,0,2,0
25-03-2023,Honeycomb,3,490,325,234,140,94,80,76,45,38,7,1
25-03-2023,Honeycomb,2,358,285,148,67,81,75,20,60,37,23,7
25-04-2021,Honeycomb,3,400,329,303,198,105,97,78,60,13,47,8
25-04-2021,Quicksilver,2,196,169,148,45,103,99,45,47,23,24,2
25-04-2021,BitterLaser,3,568,390,360,339,21,95,4,52,18,34,3
25-04-2021,CelestialInterface,3,542,206,359,43,316,58,53,38,14,24,3
25-04-2021,BitterLaser,2,733,326,536,389,147,83,76,26,13,13,0
25-04-2021,GrayPanthers,3,277,54,82,53,29,99,58,60,23,37,6
25-04-2021,Mustangs,1,719,136,458,59,399,95,79,68,7,61,6
25-04-2021,ImpactTraining,1,814,321,670,154,516,93,44,5,3,2,0
25-04-2021,Quicksilver,1,356,153,181,19,162,67,59,14,13,1,0
25-04-2021,Honeycomb,2,446,257,96,24,72,96,6,52,9,43,3
25-04-2021,CelestialInterface,3,223,159,132,79,53,72,40,40,21,19,3
25-04-2022,BitterLaser,2,476,202,265,61,204,90,2,9,2,7,0
25-04-2022,BitterLaser,3,372,276,12,11,1,92,27,42,15,27,2
25-04-2022,BitterLaser,3,352,29,250,53,197,59,2,54,26,28,6
25-04-2022,Discovery,3,922,694,268,107,161,72,22,43,9,34,3
25-04-2022,Discovery,3,552,381,69,39,30,73,71,69,10,59,6
25-04-2022,GrayPanthers,3,749,416,170,119,51,82,17,30,20,10,0
25-04-2022,Quicksilver,3,146,89,95,3,92,60,35,27,22,5,0
25-04-2022,BitterLaser,1,824,802,790,651,139,85,31,9,2,7,0
25-04-2022,ImpactTraining,1,303,192,274,205,69,92,91,73,20,53,1
25-04-2022,Discovery,1,153,60,60,6,54,76,72,28,21,7,0
25-04-2022,Quicksilver,1,457,211,67,3,64,72,7,0,0,0,0
25-04-2022,Mustangs,2,587,167,525,185,340,88,86,24,1,23,1
25-04-2022,Discovery,2,754,198,289,230,59,67,26,44,19,25,1
25-04-2023,Quicksilver,3,221,189,66,9,57,91,71,30,17,13,0
25-04-2023,PrimeSeven,3,254,29,131,60,71,54,27,5,1,4,0
25-04-2023,CelestialInterface,3,240,219,209,194,15,73,0,71,3,68,4
25-04-2023,BitterLaser,3,507,345,32,19,13,75,56,4,0,4,0
25-04-2023,Mustangs,2,267,227,259,34,225,77,6,31,18,13,1
25-04-2023,ImpactTraining,3,324,197,214,148,66,77,66,5,2,3,0
25-04-2023,Honeycomb,3,110,58,67,39,28,62,48,37,4,33,1
25-04-2023,BitterLaser,2,366,257,133,39,94,100,46,47,34,13,0
25-05-2021,ImpactTraining,2,627,595,117,79,38,58,48,34,12,22,3
25-05-2021,Aurora,2,283,110,32,2,30,64,30,12,11,1,0
25-05-2021,Aurora,2,547,423,377,6,371,100,81,37,33,4,3
25-05-2021,ImpactTraining,1,966,676,155,146,9,85,14,41,39,2,1
25-05-2021,Quicksilver,3,261,12,196,149,47,81,43,4,0,4,0
25-05-2021,Quicksilver,3,865,743,666,27,639,56,32,24,1,23,0
25-05-2022,Mustangs,3,436,208,265,62,203,76,47,47,46,1,2
25-05-2022,Aurora,3,360,309,186,84,102,72,1,31,12,19,2
25-05-2022,Mustangs,2,904,684,620,584,36,76,74,23,12,11,2
25-05-2022,Aurora,2,850,113,234,101,133,67,1,50,8,42,4
25-05-2022,Discovery,2,152,146,121,13,108,94,86,20,1,19,2
25-05-2022,Quicksilver,1,100,60,97,71,26,69,68,18,3,15,1
25-05-2022,Aurora,3,588,194,542,102,440,77,62,0,0,0,0
25-05-2022,Aurora,2,366,170,2,0,2,56,33,24,6,18,2
25-05-2022,Aurora,3,416,6,320,55,265,98,92,1,0,1,0
25-05-2023,Aurora,2,892,101,320,258,62,62,54,54,45,9,3
25-05-2023,Discovery,3,497,483,441,372,69,86,24,85,3,82,1
25-05-2023,Aurora,1,444,12,89,82,7,88,53,28,2,26,2
25-05-2023,GrayPanthers,1,308,227,35,22,13,68,57,46,0,46,4
25-05-2023,Mustangs,1,959,810,780,117,663,76,57,74,43,31,1
25-05-2023,ImpactTraining,1,516,433,456,54,402,94,2,43,34,9,4
25-05-2023,Aurora,2,351,170,308,110,198,75,55,0,0,0,0
25-05-2023,Quicksilver,3,841,517,115,73,42,80,28,72,71,1,9
25-05-2023,Honeycomb,1,606,131,592,115,477,100,7,69,24,45,7
25-05-2023,ImpactTraining,1,845,704,560,553,7,86,75,24,0,24,2
25-05-2023,Aurora,3,716,267,541,359,182,62,52,11,3,8,0
25-05-2023,BitterLaser,3,159,67,104,82,22,67,4,24,20,4,0
25-05-2023,CelestialInterface,1,540,70,56,32,24,91,68,3,0,3,0
25-06-2021,ImpactTraining,3,791,570,519,132,387,82,15,26,22,4,1
25-06-2021,Discovery,2,852,652,456,351,105,57,20,8,6,2,0
25-06-2021,Aurora,3,310,263,93,55,38,80,15,5,3,2,0
25-06-2021,Mustangs,3,643,46,414,204,210,62,55,5,0,5,0
25-06-2021,CelestialInterface,3,595,379,160,129,31,87,52,45,26,19,4
25-06-2021,Honeycomb,3,759,55,675,631,44,92,7,62,2,60,1
25-06-2021,BitterLaser,2,334,168,245,96,149,64,16,8,1,7,0
25-06-2021,GrayPanthers,2,156,66,100,9,91,83,48,74,32,42,1
25-06-2021,Quicksilver,1,210,99,149,78,71,55,25,43,42,1,0
25-06-2021,Quicksilver,1,791,610,713,604,109,83,11,29,26,3,0
25-06-2022,Aurora,2,218,176,167,85,82,57,19,51,50,1,0
25-06-2022,Discovery,1,209,107,184,161,23,62,30,15,2,13,1
25-06-2022,CelestialInterface,1,108,5,33,18,15,54,53,49,46,3,1
25-06-2022,Aurora,1,166,153,82,77,5,88,16,56,7,49,6
25-06-2022,Honeycomb,3,616,297,9,7,2,74,58,10,4,6,0
25-06-2022,Aurora,3,371,145,285,184,101,55,14,52,5,47,5
25-06-2022,Quicksilver,1,384,72,346,102,244,56,37,17,11,6,0
25-06-2023,BitterLaser,3,779,228,381,354,27,77,43,19,16,3,0
25-06-2023,CelestialInterface,1,483,163,166,42,124,100,14,81,24,57,7
25-06-2023,ImpactTraining,2,682,548,8,2,6,51,11,34,1,33,0
25-06-2023,Discovery,1,127,67,98,84,14,99,56,13,5,8,0
25-06-2023,BitterLaser,2,499,429,346,324,22,72,68,3,2,1,0
25-06-2023,BitterLaser,1,118,111,46,29,17,67,39,32,7,25,2
25-06-2023,Aurora,1,703,223,57,24,33,88,57,12,6,6,0
25-06-2023,GrayPanthers,3,894,186,123,122,1,91,88,67,54,13,3
25-06-2023,BitterLaser,1,543,46,104,6,98,50,19,45,37,8,3
25-06-2023,CelestialInterface,2,305,301,303,281,22,99,91,21,7,14,0
25-07-2021,Honeycomb,2,121,108,52,16,36,91,68,82,32,50,2
25-07-2021,Quicksilver,2,423,411,87,41,46,75,54,60,50,10,2
25-07-2021,Honeycomb,2,240,28,132,54,78,89,69,13,10,3,0
25-07-2021,Mustangs,3,494,301,222,16,206,60,42,46,18,28,1
25-07-2021,PrimeSeven,1,157,103,109,40,69,80,59,50,8,42,5
25-07-2021,ImpactTraining,1,970,819,92,26,66,87,13,23,20,3,2
25-07-2021,Quicksilver,1,428,85,252,213,39,93,28,19,4,15,0
25-07-2022,CelestialInterface,2,197,165,165,139,26,62,23,23,8,15,0
25-07-2022,Mustangs,1,151,3,140,4,136,93,44,5,4,1,0
25-07-2022,GrayPanthers,2,146,13,38,10,28,57,36,26,21,5,1
25-07-2022,BitterLaser,2,681,331,542,334,208,82,67,39,16,23,1
25-07-2022,BitterLaser,1,687,413,37,5,32,67,53,26,5,21,0
25-07-2022,Mustangs,1,486,94,135,2,133,91,17,86,33,53,11
25-07-2022,Mustangs,2,640,386,13,4,9,89,7,33,24,9,2
25-07-2022,Mustangs,3,384,323,369,346,23,55,47,30,22,8,3
25-07-2022,Discovery,1,580,327,458,457,1,81,41,6,4,2,0
25-07-2022,Quicksilver,2,637,581,147,111,36,72,50,16,14,2,0
25-07-2022,ImpactTraining,1,740,180,69,50,19,99,28,54,46,8,2
25-07-2022,Honeycomb,3,138,18,30,15,15,87,42,41,12,29,2
25-07-2022,Honeycomb,1,345,15,156,51,105,53,5,51,8,43,6
25-07-2023,PrimeSeven,2,211,88,16,11,5,74,70,23,2,21,0
25-07-2023,Mustangs,2,380,88,104,20,84,95,76,45,17,28,3
25-07-2023,Honeycomb,2,220,139,171,70,101,65,8,14,2,12,0
25-07-2023,PrimeSeven,1,385,106,180,125,55,60,0,35,5,30,3
25-07-2023,Quicksilver,2,390,92,232,64,168,82,48,56,18,38,5
25-07-2023,PrimeSeven,1,395,120,10,6,4,80,36,35,21,14,4
25-07-2023,Mustangs,2,448,361,72,43,29,90,27,67,13,54,1
25-07-2023,PrimeSeven,1,544,258,376,73,303,52,42,41,40,1,0
25-07-2023,Discovery,3,732,500,435,56,379,57,20,21,8,13,2
25-08-2021,Quicksilver,3,984,304,787,286,501,53,8,49,40,9,4
25-08-2021,Aurora,3,351,1,118,43,75,93,37,11,0,11,0
25-08-2021,GrayPanthers,3,614,544,513,492,21,72,68,40,16,24,2
25-08-2021,Aurora,1,156,99,1,0,1,72,57,17,5,12,0
25-08-2021,BitterLaser,1,239,85,97,62,35,75,57,40,22,18,2
25-08-2021,Mustangs,1,452,303,132,107,25,62,46,10,6,4,0
25-08-2021,CelestialInterface,3,951,151,876,35,841,97,36,31,23,8,3
25-08-2022,ImpactTraining,1,902,760,794,757,37,74,64,37,32,5,0
25-08-2022,Mustangs,1,909,341,434,31,403,90,5,64,0,64,8
25-08-2022,Quicksilver,1,632,201,359,281,78,77,18,73,29,44,5
25-08-2022,Honeycomb,1,659,479,59,49,10,61,59,50,28,22,4
25-08-2022,CelestialInterface,2,669,403,261,57,204,65,7,48,39,9,1
25-08-2022,Discovery,3,691,588,47,36,11,93,55,81,23,58,7
25-08-2022,PrimeSeven,3,443,120,210,65,145,70,2,58,24,34,3
25-08-2022,PrimeSeven,3,565,211,273,225,48,70,58,29,9,20,2
25-08-2022,GrayPanthers,1,902,585,699,629,70,52,34,15,5,10,0
25-08-2023,Mustangs,2,746,460,258,65,193,92,18,76,1,75,9
25-08-2023,Discovery,2,722,163,636,252,384,94,87,33,9,24,3
25-08-2023,Quicksilver,1,901,394,377,316,61,61,4,43,14,29,3
25-08-2023,ImpactTraining,3,666,27,92,27,65,53,47,41,4,37,4
25-09-2021,CelestialInterface,2,425,183,270,120,150,98,8,43,28,15,2
25-09-2021,Aurora,1,236,105,216,135,81,66,15,29,16,13,1
25-09-2021,CelestialInterface,2,696,306,583,51,532,84,66,25,5,20,0
25-09-2022,Discovery,1,810,404,337,106,231,67,43,42,40,2,1
25-09-2022,CelestialInterface,2,505,292,455,47,408,85,26,35,30,5,0
25-09-2022,ImpactTraining,3,246,91,229,15,214,100,87,52,45,7,3
25-09-2022,CelestialInterface,3,274,207,124,12,112,93,51,42,39,3,4
25-09-2022,CelestialInterface,3,400,274,181,80,101,84,9,76,21,55,9
25-09-2022,Quicksilver,2,311,46,186,118,68,61,52,9,8,1,0
25-09-2022,ImpactTraining,1,428,189,343,234,109,99,79,87,18,69,12
25-09-2022,Mustangs,2,985,926,232,145,87,52,29,22,9,13,1
25-09-2022,Honeycomb,2,897,402,480,405,75,80,3,32,28,4,0
25-09-2022,Quicksilver,3,483,166,124,56,68,57,56,39,6,33,0
25-09-2022,Quicksilver,1,424,116,48,20,28,61,24,49,22,27,3
25-09-2023,Honeycomb,3,339,186,331,46,285,70,34,68,28,40,9
25-09-2023,Aurora,1,964,2,55,52,3,83,49,19,4,15,0
25-09-2023,Honeycomb,2,223,221,214,101,113,93,90,4,0,4,0
25-09-2023,Aurora,3,587,119,363,275,88,69,68,40,37,3,0
25-10-2021,PrimeSeven,2,749,592,353,237,116,83,42,24,23,1,2
25-10-2021,PrimeSeven,2,204,100,114,44,70,97,50,27,10,17,2
25-10-2021,Quicksilver,2,754,433,498,89,409,62,28,5,3,2,0
25-10-2021,Mustangs,3,694,374,400,229,171,98,35,19,11,8,1
25-10-2021,GrayPanthers,3,292,160,71,52,19,60,21,57,4,53,3
25-10-2021,Aurora,3,764,622,579,374,205,82,30,24,8,16,2
25-10-2021,GrayPanthers,2,144,10,48,11,37,76,7,1,0,1,0
25-10-2021,BitterLaser,1,983,175,806,342,464,60,43,42,0,42,2
25-10-2022,Honeycomb,1,886,629,177,55,122,99,59,25,14,11,1
25-10-2022,CelestialInterface,1,488,189,359,47,312,67,32,15,8,7,0
25-10-2022,GrayPanthers,3,803,131,68,15,53,74,67,72,47,25,5
25-10-2022,PrimeSeven,2,590,126,527,36,491,97,96,41,38,3,1
25-10-2022,GrayPanthers,3,904,127,522,56,466,90,77,80,21,59,0
25-10-2022,ImpactTraining,1,994,470,794,413,381,85,29,31,8,23,3
25-10-2022,Aurora,2,944,450,296,171,125,90,26,24,6,18,0
25-10-2022,GrayPanthers,3,432,98,11,1,10,90,8,82,43,39,2
25-10-2022,GrayPanthers,1,172,68,49,23,26,57,39,12,8,4,0
25-10-2022,Aurora,3,742,242,320,201,119,96,34,32,5,27,3
25-10-2023,Quicksilver,2,191,148,74,25,49,69,5,28,13,15,3
25-10-2023,Discovery,1,398,169,242,147,95,94,61,1,0,1,0
25-10-2023,BitterLaser,1,841,507,776,342,434,83,39,35,20,15,0
25-10-2023,Quicksilver,2,219,85,151,72,79,92,50,86,53,33,0
25-10-2023,BitterLaser,3,590,408,86,31,55,70,61,53,36,17,0
25-10-2023,Quicksilver,3,443,351,426,414,12,54,28,18,1,17,1
25-10-2023,PrimeSeven,1,611,11,68,29,39,68,0,9,0,9,0
25-10-2023,PrimeSeven,2,293,19,23,3,20,51,49,49,45,4,6
25-10-2023,Aurora,1,603,299,129,84,45,81,46,14,5,9,1
25-10-2023,ImpactTraining,2,481,301,145,51,94,95,32,24,1,23,1
25-11-2021,Discovery,3,924,107,347,272,75,76,52,75,11,64,9
25-11-2021,PrimeSeven,1,523,444,318,125,193,70,25,1,0,1,0
25-11-2021,Discovery,3,899,414,540,263,277,76,6,26,12,14,1
25-11-2021,BitterLaser,2,351,133,45,12,33,54,24,53,16,37,3
25-11-2021,Honeycomb,2,210,140,0,0,0,81,9,62,7,55,3
25-11-2021,Discovery,3,914,224,651,339,312,81,57,26,8,18,1
25-11-2021,Aurora,1,404,291,125,46,79,85,59,56,48,8,5
25-11-2021,Mustangs,1,350,189,175,147,28,88,70,66,23,43,0
25-11-2021,Aurora,3,575,435,130,19,111,57,18,3,2,1,0
25-11-2021,Mustangs,3,604,387,505,251,254,83,22,11,5,6,0
25-11-2021,PrimeSeven,1,999,589,843,476,367,76,7,53,30,23,2
25-11-2021,Honeycomb,1,217,15,103,73,30,76,47,61,21,40,3
25-11-2022,ImpactTraining,1,420,200,96,74,22,100,10,33,23,10,1
25-11-2022,Mustangs,2,342,160,63,36,27,91,26,13,12,1,0
25-11-2022,Honeycomb,1,769,759,606,84,522,72,23,8,6,2,0
25-11-2022,BitterLaser,1,512,502,495,490,5,83,22,35,16,19,3
25-11-2022,ImpactTraining,3,862,641,712,268,444,100,64,6,5,1,0
25-11-2022,Honeycomb,3,773,89,317,141,176,69,5,21,12,9,2
25-11-2023,Quicksilver,3,438,268,420,133,287,93,6,71,43,28,9
25-11-2023,GrayPanthers,3,848,619,705,231,474,89,21,54,37,17,5
25-11-2023,Discovery,2,495,54,373,80,293,95,77,92,91,1,5
25-11-2023,GrayPanthers,3,677,132,241,153,88,92,50,37,20,17,1
25-11-2023,CelestialInterface,2,748,217,520,393,127,51,14,2,0,2,0
25-11-2023,Quicksilver,1,583,439,309,264,45,70,44,8,5,3,0
25-11-2023,Discovery,2,781,698,576,399,177,82,64,34,4,30,1
25-11-2023,Mustangs,3,562,367,364,186,178,51,10,45,27,18,5
25-11-2023,CelestialInterface,1,977,648,375,36,339,64,20,2,1,1,0
25-12-2021,Mustangs,2,372,102,24,8,16,88,8,86,74,12,7
25-12-2021,Aurora,1,879,807,564,192,372,65,27,53,30,23,4
25-12-2021,Quicksilver,1,481,74,312,89,223,51,23,45,1,44,5
25-12-2021,PrimeSeven,2,988,510,609,547,62,52,7,6,5,1,0
25-12-2021,Quicksilver,1,696,380,648,524,124,97,27,46,10,36,4
25-12-2021,ImpactTraining,2,506,112,119,33,86,98,61,57,22,35,6
25-12-2021,Discovery,2,995,45,602,409,193,75,68,43,26,17,5
25-12-2021,BitterLaser,2,846,302,781,137,644,69,0,32,10,22,0
25-12-2021,ImpactTraining,3,515,490,373,284,89,87,51,59,55,4,5
25-12-2022,Mustangs,2,464,207,393,333,60,86,81,64,52,12,3
25-12-2022,CelestialInterface,1,421,62,236,71,165,87,4,6,1,5,0
25-12-2022,PrimeSeven,1,934,797,484,321,163,61,20,30,9,21,3
25-12-2022,CelestialInterface,1,618,285,172,48,124,88,25,81,17,64,6
25-12-2022,ImpactTraining,3,127,6,3,1,2,54,20,31,24,7,2
25-12-2022,CelestialInterface,2,818,285,477,102,375,58,23,11,4,7,0
25-12-2022,GrayPanthers,3,586,424,55,13,42,55,4,32,31,1,3
25-12-2022,Mustangs,3,759,647,678,405,273,79,54,60,14,46,4
25-12-2022,PrimeSeven,3,461,351,238,145,93,73,6,12,6,6,0
25-12-2022,ImpactTraining,3,211,132,170,69,101,84,82,83,55,28,2
25-12-2022,Mustangs,1,639,486,151,36,115,90,2,86,74,12,9
25-12-2022,CelestialInterface,3,319,213,312,208,104,82,19,7,0,7,0
25-12-2022,GrayPanthers,3,342,224,238,200,38,63,36,10,2,8,0
25-12-2022,Quicksilver,2,810,195,267,16,251,88,31,10,9,1,0
25-12-2023,Aurora,3,920,727,626,410,216,81,16,63,29,34,3
25-12-2023,Quicksilver,1,293,206,290,35,255,91,16,89,69,20,11
25-12-2023,Mustangs,3,258,197,54,40,14,84,56,0,0,0,0
25-12-2023,Quicksilver,2,333,268,16,4,12,57,14,51,20,31,4
25-12-2023,ImpactTraining,3,398,393,375,205,170,94,78,73,28,45,3
25-12-2023,Honeycomb,3,976,349,740,430,310,55,33,32,27,5,1
25-12-2023,Honeycomb,3,728,571,365,309,56,100,16,2,1,1,0
25-12-2023,Mustangs,3,453,243,252,108,144,77,58,45,41,4,2
25-12-2023,GrayPanthers,2,252,132,70,50,20,96,15,24,12,12,0
25-12-2023,GrayPanthers,2,601,537,410,129,281,68,43,48,38,10,4
25-12-2023,ImpactTraining,3,241,172,130,11,119,91,16,49,2,47,5
25-12-2023,BitterLaser,2,727,627,271,154,117,65,28,64,17,47,2
26-01-2021,Mustangs,1,100,51,37,19,18,85,26,69,18,51,4
26-01-2021,GrayPanthers,1,607,544,377,36,341,86,10,14,6,8,0
26-01-2021,Quicksilver,3,912,705,714,509,205,85,6,42,36,6,5
26-01-2021,Quicksilver,2,424,63,183,135,48,93,30,69,43,26,4
26-01-2021,PrimeSeven,1,211,128,79,13,66,80,24,28,17,11,1
26-01-2021,Quicksilver,1,649,617,397,354,43,96,86,36,16,20,1
26-01-2021,BitterLaser,2,990,953,390,235,155,96,82,81,30,51,5
26-01-2021,CelestialInterface,1,709,325,217,66,151,57,9,56,45,11,5
26-01-2021,Honeycomb,2,289,12,156,93,63,68,18,45,18,27,3
26-01-2021,Honeycomb,3,859,46,119,33,86,73,39,17,6,11,0
26-01-2021,Honeycomb,1,719,421,656,26,630,53,2,27,11,16,3
26-01-2021,ImpactTraining,3,791,372,682,330,352,78,20,36,18,18,4
26-01-2021,CelestialInterface,3,732,664,213,0,213,54,36,4,0,4,0
26-01-2021,Mustangs,1,879,752,153,149,4,74,23,33,21,12,2
26-01-2022,Quicksilver,1,269,191,31,17,14,53,46,13,6,7,0
26-01-2022,BitterLaser,2,171,130,141,131,10,77,2,43,33,10,5
26-01-2022,ImpactTraining,1,129,44,59,41,18,66,10,5,3,2,0
26-01-2022,Aurora,3,729,398,554,132,422,67,40,59,36,23,6
26-01-2022,BitterLaser,2,492,145,44,18,26,52,43,38,33,5,4
26-01-2022,BitterLaser,2,302,284,175,85,90,55,23,34,25,9,0
26-01-2022,PrimeSeven,3,815,358,190,158,32,89,52,31,9,22,1
26-01-2022,Mustangs,2,486,145,204,18,186,83,17,12,9,3,0
26-01-2023,BitterLaser,2,183,94,77,70,7,86,12,55,19,36,4
26-01-2023,BitterLaser,1,886,760,264,8,256,51,6,23,10,13,1
26-01-2023,GrayPanthers,2,467,80,263,32,231,59,30,26,20,6,2
26-01-2023,GrayPanthers,2,214,211,191,4,187,56,29,41,25,16,5
26-01-2023,Discovery,2,929,325,571,62,509,63,34,34,9,25,3
26-01-2023,ImpactTraining,2,151,92,139,102,37,77,26,38,12,26,1
26-01-2023,Mustangs,3,748,312,728,164,564,77,41,51,1,50,3
26-01-2023,CelestialInterface,2,241,231,221,91,130,88,74,76,14,62,7
26-01-2023,Mustangs,3,151,70,42,15,27,73,37,22,13,9,0
26-02-2021,Aurora,1,926,885,230,191,39,79,67,3,2,1,0
26-02-2021,CelestialInterface,2,537,197,273,62,211,84,59,13,4,9,0
26-02-2021,Mustangs,1,111,66,55,18,37,53,11,5,0,5,0
26-02-2021,Honeycomb,1,141,53,78,54,24,75,5,40,25,15,5
26-02-2021,Honeycomb,3,658,540,455,265,190,65,59,35,23,12,4
26-02-2021,BitterLaser,2,268,150,86,19,67,58,0,44,29,15,0
26-02-2021,CelestialInterface,2,407,7,249,121,128,98,25,80,22,58,1
26-02-2021,PrimeSeven,2,217,209,202,5,197,70,52,8,3,5,0
26-02-2021,Quicksilver,1,959,872,231,75,156,60,51,21,3,18,0
26-02-2021,Mustangs,2,825,394,317,92,225,94,88,9,8,1,0
26-02-2021,PrimeSeven,2,110,9,36,15,21,69,58,18,6,12,0
26-02-2021,GrayPanthers,2,614,33,416,98,318,64,43,43,6,37,4
26-02-2021,Quicksilver,3,744,105,546,489,57,67,28,23,19,4,0
26-02-2021,GrayPanthers,2,895,160,280,119,161,88,28,64,57,7,5
26-02-2021,GrayPanthers,1,979,424,874,284,590,71,0,58,29,29,6
26-02-2021,Discovery,1,131,7,44,27,17,88,70,28,22,6,1
26-02-2022,Aurora,1,316,256,64,5,59,61,45,48,30,18,0
26-02-2022,Mustangs,3,980,350,781,521,260,87,77,61,59,2,1
26-02-2022,CelestialInterface,2,641,264,17,16,1,56,36,1,0,1,0
26-02-2022,ImpactTraining,1,863,232,322,189,133,98,38,58,43,15,2
26-02-2022,ImpactTraining,2,345,149,331,262,69,62,61,3,2,1,0
26-02-2022,Discovery,3,485,313,368,226,142,100,66,36,18,18,4
26-02-2022,PrimeSeven,3,551,13,526,259,267,68,46,51,22,29,4
26-02-2022,ImpactTraining,2,219,173,72,20,52,93,82,20,19,1,1
26-02-2023,Mustangs,3,422,271,402,269,133,65,31,5,0,5,0
26-02-2023,Discovery,3,747,335,419,87,332,61,15,25,21,4,1
26-02-2023,Mustangs,2,101,56,4,1,3,86,20,48,4,44,2
26-02-2023,Aurora,1,891,560,344,182,162,55,14,32,16,16,3
26-02-2023,Honeycomb,1,417,233,220,113,107,91,72,68,33,35,7
26-02-2023,Quicksilver,2,399,135,316,272,44,59,19,2,1,1,0
26-02-2023,BitterLaser,3,865,659,619,480,139,66,29,43,4,39,3
26-02-2023,GrayPanthers,1,406,382,136,96,40,77,23,35,18,17,2
26-02-2023,PrimeSeven,2,354,278,202,30,172,100,54,4,1,3,0
26-02-2023,Discovery,3,253,204,97,76,21,57,54,49,26,23,2
26-02-2023,Quicksilver,1,310,214,302,171,131,61,5,45,16,29,5
26-03-2021,Discovery,2,607,484,555,59,496,96,18,84,28,56,2
26-03-2021,BitterLaser,3,945,207,853,565,288,62,45,15,12,3,1
26-03-2021,Discovery,2,295,271,247,43,204,97,78,34,4,30,1
26-03-2021,Aurora,1,964,515,47,40,7,71,52,57,34,23,7
26-03-2021,CelestialInterface,2,540,415,28,15,13,72,50,45,20,25,3
26-03-2021,PrimeSeven,3,920,881,863,608,255,75,60,27,0,27,3
26-03-2021,Honeycomb,3,413,113,178,134,44,92,91,66,54,12,1
26-03-2021,CelestialInterface,2,717,415,417,194,223,80,6,44,35,9,2
26-03-2021,PrimeSeven,2,692,144,183,132,51,79,20,0,0,0,0
26-03-2021,ImpactTraining,2,854,700,296,277,19,64,55,5,2,3,0
26-03-2021,Mustangs,1,957,472,203,9,194,57,13,0,0,0,0
26-03-2021,Quicksilver,3,283,271,121,3,118,76,27,4,3,1,0
26-03-2022,Discovery,1,475,290,175,168,7,97,31,83,21,62,3
26-03-2022,Discovery,2,682,11,287,156,131,76,14,35,30,5,1
26-03-2022,GrayPanthers,2,499,305,78,19,59,94,26,46,23,23,1
26-03-2022,Mustangs,1,882,376,280,214,66,76,74,33,19,14,0
26-03-2022,Discovery,3,911,246,481,286,195,57,6,44,3,41,0
26-03-2022,BitterLaser,1,135,109,51,9,42,72,35,67,41,26,7
26-03-2022,ImpactTraining,2,734,468,268,211,57,64,2,57,56,1,4
26-03-2022,Aurora,3,689,586,289,35,254,52,12,18,15,3,1
26-03-2023,Quicksilver,1,272,77,63,52,11,90,72,36,0,36,2
26-03-2023,PrimeSeven,2,844,558,562,444,118,91,79,5,4,1,0
26-03-2023,GrayPanthers,2,158,137,112,110,2,77,58,45,22,23,0
26-03-2023,GrayPanthers,3,901,58,756,745,11,83,17,43,23,20,5
26-03-2023,GrayPanthers,3,357,125,41,38,3,59,13,2,1,1,0
26-03-2023,Quicksilver,2,235,40,49,12,37,73,51,1,0,1,0
26-03-2023,Discovery,3,232,158,190,110,80,86,64,57,15,42,6
26-03-2023,Aurora,1,267,107,216,170,46,71,43,21,14,7,1
26-03-2023,BitterLaser,1,959,704,19,17,2,62,8,45,15,30,4
26-03-2023,Discovery,1,255,62,231,53,178,79,41,38,29,9,2
26-04-2021,BitterLaser,3,731,572,319,243,76,55,36,5,2,3,0
26-04-2021,GrayPanthers,1,976,148,611,497,114,86,10,37,11,26,1
26-04-2021,Discovery,3,473,1,351,341,10,50,18,27,3,24,0
26-04-2021,BitterLaser,2,423,291,178,87,91,95,57,85,32,53,10
26-04-2021,CelestialInterface,3,879,733,379,106,273,74,65,63,34,29,6
26-04-2021,Quicksilver,3,327,51,296,240,56,92,89,27,12,15,1
26-04-2021,CelestialInterface,1,168,139,11,10,1,70,56,60,4,56,0
26-04-2021,ImpactTraining,1,931,748,734,624,110,56,28,15,1,14,1
26-04-2021,ImpactTraining,1,959,628,36,13,23,79,53,29,19,10,0
26-04-2022,Aurora,3,978,639,302,50,252,50,36,24,14,10,1
26-04-2022,PrimeSeven,1,814,225,597,311,286,71,2,48,9,39,1
26-04-2022,Quicksilver,2,321,224,4,3,1,85,31,4,3,1,0
26-04-2022,Mustangs,2,464,138,108,56,52,52,39,1,0,1,0
26-04-2022,CelestialInterface,1,170,36,13,4,9,71,28,41,9,32,2
26-04-2022,BitterLaser,1,127,107,20,9,11,61,22,58,9,49,1
26-04-2022,Discovery,1,376,373,368,284,84,58,35,28,13,15,2
26-04-2022,PrimeSeven,1,540,496,331,165,166,77,47,31,19,12,3
26-04-2022,PrimeSeven,2,839,333,298,28,270,63,22,43,18,25,3
26-04-2023,ImpactTraining,1,512,122,221,41,180,58,53,23,2,21,0
26-04-2023,Mustangs,1,649,274,545,265,280,92,41,77,18,59,8
26-04-2023,Honeycomb,2,777,668,703,586,117,59,11,41,39,2,1
26-04-2023,BitterLaser,2,103,1,78,5,73,52,11,49,41,8,3
26-04-2023,Mustangs,3,504,197,416,289,127,78,64,48,21,27,0
26-04-2023,Aurora,2,595,315,158,68,90,81,60,63,48,15,7
26-04-2023,ImpactTraining,2,276,20,21,15,6,64,47,3,2,1,0
26-05-2021,Discovery,3,425,170,196,92,104,56,38,17,10,7,0
26-05-2021,ImpactTraining,2,115,32,4,3,1,80,51,78,69,9,9
26-05-2021,ImpactTraining,3,740,266,646,233,413,61,50,22,20,2,1
26-05-2021,BitterLaser,3,113,58,62,4,58,71,54,51,46,5,5
26-05-2021,PrimeSeven,1,984,91,346,214,132,93,23,68,38,30,7
26-05-2021,GrayPanthers,2,167,91,60,44,16,67,3,19,9,10,1
26-05-2021,BitterLaser,2,391,101,383,297,86,56,52,2,0,2,0
26-05-2021,ImpactTraining,1,277,120,103,52,51,82,51,52,24,28,4
26-05-2021,Discovery,1,486,278,330,318,12,98,91,91,2,89,3
26-05-2021,ImpactTraining,1,594,341,153,4,149,87,62,83,73,10,9
26-05-2021,GrayPanthers,3,345,319,77,13,64,63,59,14,5,9,1
26-05-2022,Honeycomb,2,747,57,392,138,254,79,47,22,13,9,0
26-05-2022,Aurora,3,922,703,295,55,240,51,22,8,6,2,0
26-05-2022,PrimeSeven,2,860,513,676,124,552,95,83,38,22,16,2
26-05-2022,Quicksilver,3,831,730,575,177,398,73,23,36,20,16,4
26-05-2022,Aurora,3,887,790,736,79,657,72,29,26,17,9,0
26-05-2022,Honeycomb,3,462,437,349,136,213,54,2,2,1,1,0
26-05-2022,CelestialInterface,1,319,128,4,1,3,65,22,49,31,18,3
26-05-2022,Discovery,1,609,356,596,286,310,82,55,17,13,4,1
26-05-2023,Discovery,3,940,93,201,147,54,85,62,46,44,2,1
26-05-2023,Honeycomb,2,653,68,649,462,187,64,10,8,2,6,0
26-05-2023,ImpactTraining,3,870,729,510,171,339,64,60,56,36,20,4
26-05-2023,Quicksilver,3,926,881,46,26,20,76,26,63,17,46,4
26-05-2023,GrayPanthers,1,435,225,91,12,79,51,19,35,21,14,2
26-05-2023,BitterLaser,2,758,374,726,273,453,59,19,14,10,4,0
26-05-2023,Honeycomb,3,233,197,187,119,68,80,15,56,35,21,0
26-05-2023,Mustangs,2,649,402,386,195,191,97,83,3,1,2,0
26-05-2023,Mustangs,3,195,127,95,73,22,99,90,3,0,3,0
26-05-2023,Quicksilver,3,137,60,38,3,35,95,82,78,14,64,1
26-05-2023,Discovery,1,858,79,332,99,233,67,10,56,44,12,7
26-05-2023,CelestialInterface,3,636,393,150,102,48,93,53,83,43,40,7
26-05-2023,BitterLaser,1,426,152,182,58,124,57,24,4,3,1,0
26-05-2023,Quicksilver,3,968,248,823,669,154,60,6,18,17,1,1
26-06-2021,CelestialInterface,2,629,319,98,89,9,53,13,11,9,2,0
26-06-2021,BitterLaser,2,587,584,507,323,184,80,78,8,5,3,0
26-06-2021,Aurora,3,413,152,86,49,37,52,15,39,24,15,0
26-06-2021,Discovery,1,619,41,71,38,33,73,39,19,8,11,1
26-06-2021,Honeycomb,2,899,13,349,145,204,52,19,32,16,16,3
26-06-2021,Mustangs,3,834,75,748,375,373,89,22,31,14,17,1
26-06-2021,Discovery,1,994,202,983,883,100,60,27,41,33,8,4
26-06-2021,Honeycomb,1,904,703,208,60,148,56,8,17,8,9,0
26-06-2021,ImpactTraining,2,135,14,75,41,34,88,9,81,14,67,8
26-06-2022,Honeycomb,1,972,153,378,189,189,79,9,63,1,62,0
26-06-2022,Aurora,2,842,483,751,142,609,88,78,73,15,58,6
26-06-2022,Honeycomb,1,581,437,85,29,56,100,60,93,26,67,6
26-06-2022,BitterLaser,3,786,227,185,35,150,72,42,49,9,40,2
26-06-2022,ImpactTraining,2,167,165,143,55,88,94,31,22,17,5,1
26-06-2022,Discovery,3,787,138,15,0,15,77,51,60,45,15,6
26-06-2022,Honeycomb,3,216,78,6,5,1,79,66,54,10,44,5
26-06-2022,BitterLaser,1,623,199,392,375,17,65,9,52,48,4,6
26-06-2022,PrimeSeven,1,169,133,113,11,102,70,35,30,12,18,2
26-06-2023,Quicksilver,2,170,114,0,0,0,69,16,54,31,23,7
26-06-2023,GrayPanthers,1,164,13,61,52,9,84,79,69,49,20,7
26-06-2023,ImpactTraining,3,702,292,340,295,45,89,3,85,76,9,8
26-06-2023,CelestialInterface,2,289,167,50,17,33,81,68,69,1,68,7
26-06-2023,ImpactTraining,2,981,71,924,801,123,60,2,22,4,18,1
26-06-2023,BitterLaser,1,608,105,223,88,135,97,78,19,3,16,0
26-06-2023,PrimeSeven,3,903,299,63,49,14,92,19,35,29,6,4
26-06-2023,CelestialInterface,3,894,136,654,37,617,95,28,20,7,13,2
26-07-2021,BitterLaser,3,179,101,44,14,30,58,30,12,1,11,0
26-07-2021,PrimeSeven,2,373,327,325,24,301,77,29,32,9,23,3
26-07-2021,Honeycomb,1,734,507,21,16,5,100,46,66,22,44,2
26-07-2021,ImpactTraining,2,724,13,258,153,105,98,52,50,11,39,4
26-07-2021,Discovery,1,834,694,416,39,377,99,87,73,21,52,9
26-07-2021,Honeycomb,1,130,111,69,27,42,52,44,19,0,19,0
26-07-2021,Honeycomb,2,780,444,581,317,264,62,60,28,26,2,0
26-07-2021,Honeycomb,3,226,199,91,59,32,91,30,67,35,32,5
26-07-2022,Mustangs,2,764,519,96,48,48,100,82,85,57,28,2
26-07-2022,BitterLaser,3,331,256,206,85,121,90,5,81,52,29,10
26-07-2022,Quicksilver,1,317,275,28,21,7,54,3,17,12,5,1
26-07-2022,Discovery,2,527,319,42,2,40,68,20,23,19,4,1
26-07-2022,Honeycomb,3,682,388,627,130,497,90,82,56,22,34,5
26-07-2022,BitterLaser,2,970,147,533,312,221,89,12,48,6,42,4
26-07-2022,ImpactTraining,3,988,556,915,528,387,77,18,24,5,19,1
26-07-2022,BitterLaser,3,112,21,80,50,30,78,8,62,14,48,5
26-07-2022,BitterLaser,2,238,83,54,38,16,64,50,12,2,10,0
26-07-2022,Mustangs,1,622,110,281,58,223,81,12,20,17,3,2
26-07-2022,CelestialInterface,2,736,35,219,75,144,70,67,16,5,11,1
26-07-2023,ImpactTraining,3,724,475,459,104,355,69,4,11,7,4,0
26-07-2023,GrayPanthers,1,759,14,23,6,17,59,35,39,1,38,3
26-07-2023,PrimeSeven,1,735,265,342,75,267,71,5,70,40,30,7
26-07-2023,Quicksilver,3,850,563,56,40,16,92,59,28,2,26,2
26-07-2023,CelestialInterface,3,720,615,280,238,42,71,31,67,54,13,5
26-07-2023,Honeycomb,2,226,142,32,12,20,52,50,36,29,7,2
26-07-2023,CelestialInterface,3,501,233,142,36,106,52,29,16,1,15,1
26-07-2023,BitterLaser,1,190,155,79,63,16,86,6,8,1,7,0
26-07-2023,Quicksilver,2,904,444,288,82,206,68,16,48,33,15,5
26-07-2023,PrimeSeven,2,997,154,541,299,242,98,14,66,20,46,4
26-07-2023,ImpactTraining,2,514,368,103,66,37,79,33,54,21,33,6
26-07-2023,Discovery,3,203,50,136,78,58,56,8,1,0,1,0
26-07-2023,PrimeSeven,2,758,285,561,322,239,83,39,61,56,5,0
26-07-2023,Quicksilver,1,106,71,95,9,86,93,70,75,38,37,7
26-08-2021,Quicksilver,2,116,9,89,23,66,55,20,31,1,30,1
26-08-2021,ImpactTraining,2,220,79,163,28,135,51,17,48,40,8,6
26-08-2021,ImpactTraining,3,429,417,389,140,249,67,66,19,12,7,1
26-08-2021,GrayPanthers,1,771,492,424,328,96,98,89,6,0,6,0
26-08-2021,Mustangs,3,527,435,42,24,18,59,29,24,5,19,2
26-08-2021,Mustangs,1,162,135,117,96,21,92,45,80,13,67,6
26-08-2021,Mustangs,1,235,207,26,18,8,68,57,64,12,52,4
26-08-2022,Mustangs,1,394,68,61,2,59,90,38,74,12,62,0
26-08-2022,Discovery,3,533,263,16,3,13,94,62,25,15,10,1
26-08-2022,Honeycomb,3,423,109,87,47,40,93,31,77,62,15,3
26-08-2022,Mustangs,2,208,127,124,36,88,74,71,4,2,2,0
26-08-2022,ImpactTraining,1,867,756,604,152,452,68,41,66,62,4,1
26-08-2022,Quicksilver,1,372,21,59,47,12,65,26,11,4,7,0
26-08-2022,Discovery,3,619,576,535,483,52,52,11,24,15,9,0
26-08-2022,CelestialInterface,2,661,131,97,41,56,61,34,5,2,3,0
26-08-2023,CelestialInterface,1,852,12,428,43,385,78,41,44,1,43,5
26-08-2023,BitterLaser,3,496,103,304,0,304,70,45,68,40,28,7
26-08-2023,PrimeSeven,2,771,618,559,481,78,82,21,61,49,12,0
26-08-2023,Discovery,2,205,49,4,2,2,88,32,30,11,19,0
26-08-2023,Mustangs,3,435,227,329,92,237,90,45,46,11,35,0
26-08-2023,Aurora,2,431,125,342,132,210,90,9,67,64,3,1
26-09-2021,Aurora,1,539,265,119,111,8,100,22,90,72,18,12
26-09-2021,Honeycomb,1,713,665,443,386,57,60,7,7,4,3,0
26-09-2021,PrimeSeven,2,632,74,626,609,17,51,21,19,0,19,0
26-09-2021,Aurora,3,265,44,72,57,15,58,13,45,34,11,0
26-09-2021,Discovery,3,382,198,223,197,26,56,45,22,1,21,2
26-09-2021,PrimeSeven,3,885,487,448,171,277,71,9,38,35,3,0
26-09-2021,ImpactTraining,3,636,508,546,486,60,66,0,36,33,3,3
26-09-2021,Quicksilver,3,268,114,143,74,69,54,50,48,30,18,1
26-09-2021,Aurora,1,249,243,40,22,18,74,40,58,2,56,6
26-09-2021,CelestialInterface,1,453,132,30,13,17,85,42,46,18,28,3
26-09-2021,BitterLaser,1,405,284,113,4,109,85,36,51,29,22,5
26-09-2022,ImpactTraining,1,949,113,185,14,171,66,47,0,0,0,0
26-09-2022,CelestialInterface,3,825,450,120,28,92,95,76,76,71,5,2
26-09-2022,GrayPanthers,1,850,88,312,35,277,70,55,5,0,5,0
26-09-2022,Aurora,2,284,135,26,9,17,97,95,41,29,12,3
26-09-2022,ImpactTraining,2,313,298,293,42,251,75,29,63,50,13,4
26-09-2022,Honeycomb,3,153,119,135,117,18,56,37,36,8,28,3
26-09-2022,BitterLaser,2,694,95,83,4,79,57,44,24,0,24,1
26-09-2022,CelestialInterface,1,475,301,140,65,75,69,7,49,26,23,1
26-09-2022,Aurora,1,993,487,469,285,184,67,45,38,15,23,1
26-09-2022,BitterLaser,3,977,477,263,55,208,70,2,52,46,6,6
26-09-2022,Honeycomb,2,189,47,46,45,1,61,25,13,8,5,0
26-09-2023,BitterLaser,2,578,278,322,201,121,88,81,72,42,30,0
26-09-2023,Honeycomb,3,489,237,415,303,112,86,59,75,27,48,8
26-09-2023,Honeycomb,1,215,25,78,39,39,83,10,20,13,7,2
26-09-2023,GrayPanthers,3,561,518,430,409,21,58,20,42,7,35,0
26-09-2023,ImpactTraining,3,688,409,614,511,103,72,62,50,4,46,3
26-09-2023,Honeycomb,2,543,231,507,373,134,93,89,26,22,4,2
26-09-2023,ImpactTraining,1,181,179,118,20,98,83,5,0,0,0,0
26-09-2023,CelestialInterface,2,709,304,493,429,64,93,75,82,44,38,1
26-09-2023,Discovery,1,831,562,388,256,132,56,20,14,3,11,1
26-09-2023,PrimeSeven,2,208,129,132,46,86,78,20,24,12,12,1
26-09-2023,Mustangs,1,747,698,11,2,9,70,58,51,37,14,3
26-09-2023,PrimeSeven,2,248,244,2,1,1,73,7,39,19,20,1
26-09-2023,Quicksilver,3,605,56,578,365,213,99,6,74,13,61,9
26-10-2021,BitterLaser,1,336,207,138,108,30,58,11,46,40,6,2
26-10-2021,Mustangs,2,323,16,65,63,2,61,59,10,0,10,0
26-10-2021,GrayPanthers,1,324,144,265,253,12,82,8,66,33,33,2
26-10-2021,Honeycomb,3,798,711,214,175,39,100,19,68,67,1,7
26-10-2021,Honeycomb,3,547,68,129,19,110,87,13,8,1,7,0
26-10-2022,Mustangs,3,610,405,284,204,80,88,51,53,11,42,6
26-10-2022,PrimeSeven,1,645,383,563,122,441,96,86,22,5,17,1
26-10-2022,Discovery,3,598,293,494,106,388,75,51,63,34,29,2
26-10-2022,Quicksilver,2,597,39,124,58,66,65,20,22,11,11,1
26-10-2022,Aurora,2,548,222,422,26,396,50,10,38,9,29,1
26-10-2023,Mustangs,1,854,588,435,88,347,59,5,18,4,14,1
26-10-2023,CelestialInterface,2,171,132,84,2,82,96,51,36,28,8,2
26-10-2023,Quicksilver,2,735,32,686,238,448,98,31,41,19,22,1
26-10-2023,Mustangs,2,821,37,28,8,20,87,58,44,12,32,4
26-10-2023,Honeycomb,1,628,215,222,27,195,55,5,0,0,0,0
26-10-2023,PrimeSeven,1,205,108,144,8,136,98,11,1,0,1,0
26-11-2021,BitterLaser,2,279,134,44,26,18,54,39,29,1,28,0
26-11-2021,Quicksilver,1,103,90,34,8,26,53,15,10,6,4,0
26-11-2021,Discovery,3,688,32,470,44,426,56,19,47,18,29,6
26-11-2021,GrayPanthers,1,443,118,422,45,377,70,37,18,11,7,0
26-11-2021,BitterLaser,1,848,202,813,783,30,73,68,58,29,29,2
26-11-2021,ImpactTraining,1,473,207,180,135,45,81,24,25,6,19,0
26-11-2021,CelestialInterface,2,933,805,477,9,468,84,16,23,17,6,0
26-11-2022,Honeycomb,1,314,81,158,93,65,56,1,22,6,16,2
26-11-2022,Mustangs,3,744,108,40,15,25,68,63,58,52,6,4
26-11-2022,BitterLaser,1,891,435,658,452,206,89,20,14,5,9,1
26-11-2022,BitterLaser,1,695,97,356,169,187,70,39,53,25,28,5
26-11-2022,GrayPanthers,3,367,85,327,144,183,62,9,39,14,25,1
26-11-2022,ImpactTraining,2,308,233,31,7,24,100,43,88,55,33,6
26-11-2022,BitterLaser,1,884,688,265,115,150,89,38,87,41,46,3
26-11-2022,BitterLaser,2,139,99,42,17,25,99,64,18,17,1,0
26-11-2022,Quicksilver,3,143,20,3,1,2,61,46,18,3,15,0
26-11-2022,GrayPanthers,1,266,87,192,112,80,64,7,8,7,1,0
26-11-2023,PrimeSeven,1,722,113,523,508,15,83,64,40,4,36,1
26-11-2023,Honeycomb,1,386,46,201,90,111,73,26,51,28,23,0
26-11-2023,ImpactTraining,1,644,137,61,32,29,100,39,12,3,9,0
26-11-2023,Discovery,1,196,51,106,99,7,50,23,48,45,3,5
26-11-2023,GrayPanthers,2,456,254,397,286,111,100,54,27,20,7,0
26-11-2023,Discovery,1,487,373,67,62,5,74,63,12,8,4,0
26-11-2023,Quicksilver,3,329,220,271,22,249,67,58,35,4,31,1
26-11-2023,Quicksilver,1,316,166,25,5,20,80,4,0,0,0,0
26-11-2023,GrayPanthers,2,313,40,290,166,124,51,43,36,22,14,0
26-11-2023,Aurora,1,953,340,403,96,307,73,12,56,16,40,4
26-11-2023,Mustangs,3,413,54,127,86,41,82,60,19,10,9,1
26-11-2023,Aurora,2,571,262,143,47,96,93,15,39,18,21,3
26-12-2021,ImpactTraining,2,546,414,481,102,379,94,77,90,70,20,3
26-12-2021,Quicksilver,3,385,47,183,26,157,60,19,20,12,8,2
26-12-2021,CelestialInterface,2,185,153,122,35,87,83,34,37,35,2,0
26-12-2021,Discovery,1,407,349,135,57,78,84,58,50,33,17,5
26-12-2021,GrayPanthers,3,427,395,230,28,202,94,68,29,12,17,2
26-12-2021,Aurora,3,954,754,587,397,190,75,71,69,28,41,1
26-12-2021,BitterLaser,1,111,89,4,3,1,71,13,15,0,15,1
26-12-2022,Aurora,3,316,274,211,118,93,59,18,12,0,12,0
26-12-2022,PrimeSeven,2,108,15,21,14,7,90,51,63,58,5,0
26-12-2022,CelestialInterface,3,211,205,182,121,61,51,47,24,17,7,0
26-12-2022,Mustangs,2,476,16,115,62,53,60,30,14,6,8,1
26-12-2022,Discovery,2,813,496,790,646,144,83,31,39,19,20,1
26-12-2022,Honeycomb,1,787,664,315,314,1,59,22,33,29,4,1
26-12-2022,GrayPanthers,3,174,129,151,141,10,58,10,3,2,1,0
26-12-2022,PrimeSeven,2,959,925,385,202,183,67,18,30,4,26,2
26-12-2022,Honeycomb,1,478,297,242,65,177,88,66,17,14,3,0
26-12-2022,ImpactTraining,2,123,10,120,10,110,79,15,3,0,3,0
26-12-2022,Discovery,1,915,210,232,180,52,66,0,32,25,7,1
26-12-2022,Discovery,1,279,252,268,168,100,91,11,58,31,27,7
26-12-2022,Discovery,2,142,11,97,86,11,68,52,12,4,8,0
26-12-2023,GrayPanthers,1,884,94,624,392,232,89,56,83,1,82,8
26-12-2023,GrayPanthers,2,161,98,152,41,111,60,37,23,8,15,1
26-12-2023,Honeycomb,3,522,24,72,40,32,74,1,26,24,2,1
26-12-2023,Honeycomb,1,817,8,806,565,241,82,5,3,1,2,0
26-12-2023,Aurora,1,780,74,8,4,4,53,52,38,36,2,1
26-12-2023,Mustangs,2,915,131,875,68,807,58,28,56,39,17,6
26-12-2023,Quicksilver,1,311,190,252,206,46,71,54,40,27,13,5
26-12-2023,Honeycomb,1,470,109,277,252,25,74,45,31,4,27,1
27-01-2021,ImpactTraining,1,892,82,857,319,538,71,29,29,28,1,3
27-01-2021,Quicksilver,3,749,86,165,105,60,91,33,53,34,19,3
27-01-2021,PrimeSeven,2,947,820,619,422,197,53,40,24,10,14,0
27-01-2021,Aurora,2,236,183,200,8,192,75,15,30,9,21,1
27-01-2021,Mustangs,1,397,261,76,60,16,62,10,52,35,17,5
27-01-2021,BitterLaser,1,325,148,278,26,252,69,15,34,16,18,4
27-01-2021,PrimeSeven,3,743,19,629,261,368,70,29,13,3,10,0
27-01-2021,Quicksilver,2,501,500,471,281,190,57,24,2,1,1,0
27-01-2021,GrayPanthers,3,389,231,266,226,40,71,29,28,6,22,1
27-01-2021,GrayPanthers,2,808,319,427,93,334,91,61,32,9,23,1
27-01-2022,Discovery,1,363,273,101,57,44,56,50,23,3,20,1
27-01-2022,Discovery,2,725,331,483,285,198,83,7,39,15,24,4
27-01-2022,BitterLaser,3,556,170,418,333,85,56,22,41,11,30,5
27-01-2022,ImpactTraining,1,684,576,208,80,128,70,32,58,38,20,1
27-01-2022,Honeycomb,2,943,459,805,265,540,86,71,24,10,14,1
27-01-2022,GrayPanthers,1,939,926,113,25,88,85,61,52,23,29,4
27-01-2022,Discovery,1,573,171,551,249,302,86,20,1,0,1,0
27-01-2022,GrayPanthers,1,208,94,187,87,100,55,41,37,36,1,2
27-01-2023,Discovery,1,324,307,105,31,74,75,62,25,6,19,0
27-01-2023,BitterLaser,1,688,425,587,278,309,81,62,68,67,1,2
27-01-2023,Mustangs,1,734,713,360,99,261,82,23,69,49,20,9
27-01-2023,ImpactTraining,2,1000,157,60,12,48,76,7,28,27,1,1
27-01-2023,ImpactTraining,3,413,145,327,92,235,73,47,1,0,1,0
27-01-2023,Mustangs,1,971,690,415,262,153,98,7,39,24,15,3
27-01-2023,ImpactTraining,2,461,123,103,61,42,86,79,70,49,21,6
27-01-2023,BitterLaser,2,762,250,666,360,306,90,15,14,7,7,0
27-01-2023,Discovery,3,408,258,386,67,319,57,52,40,21,19,5
27-01-2023,Aurora,3,977,156,616,543,73,56,13,3,0,3,0
27-01-2023,ImpactTraining,2,474,323,81,58,23,98,94,74,24,50,5
27-01-2023,Quicksilver,2,389,387,351,56,295,59,40,44,9,35,5
27-01-2023,Honeycomb,3,294,267,240,199,41,99,79,56,52,4,7
27-01-2023,ImpactTraining,3,201,166,172,169,3,82,81,13,0,13,0
27-01-2023,Quicksilver,1,179,54,163,146,17,73,52,3,2,1,0
27-02-2021,Aurora,2,345,39,74,62,12,93,5,48,11,37,6
27-02-2021,PrimeSeven,2,300,152,10,5,5,90,12,74,1,73,5
27-02-2021,Aurora,2,780,282,526,107,419,51,28,16,13,3,0
27-02-2021,Honeycomb,2,366,284,95,81,14,92,88,66,52,14,5
27-02-2021,Discovery,3,818,660,608,46,562,83,77,51,36,15,5
27-02-2021,CelestialInterface,3,598,234,117,73,44,93,30,26,17,9,0
27-02-2021,Discovery,1,194,191,60,47,13,64,45,29,1,28,0
27-02-2021,Aurora,2,221,206,142,129,13,59,38,44,21,23,2
27-02-2022,Aurora,1,425,184,155,53,102,86,74,69,37,32,3
27-02-2022,Honeycomb,3,654,26,193,39,154,74,57,32,1,31,2
27-02-2022,Honeycomb,1,967,612,69,56,13,93,57,2,0,2,0
27-02-2022,PrimeSeven,3,372,14,340,43,297,73,2,63,0,63,2
27-02-2022,PrimeSeven,1,799,152,223,108,115,95,53,33,26,7,3
27-02-2022,BitterLaser,1,884,346,717,58,659,65,26,39,0,39,1
27-02-2023,GrayPanthers,3,855,746,390,379,11,81,64,61,43,18,4
27-02-2023,Quicksilver,3,147,134,55,8,47,100,32,28,26,2,2
27-02-2023,ImpactTraining,1,405,346,6,0,6,69,48,3,2,1,0
27-02-2023,Quicksilver,1,476,124,286,80,206,69,46,13,12,1,0
27-02-2023,Honeycomb,2,404,244,81,15,66,65,22,11,1,10,0
27-02-2023,GrayPanthers,1,840,448,9,7,2,56,18,0,0,0,0
27-02-2023,GrayPanthers,1,118,58,102,39,63,90,23,60,15,45,7
27-02-2023,GrayPanthers,2,733,657,325,26,299,84,22,37,32,5,0
27-02-2023,Mustangs,1,419,345,304,131,173,70,68,28,0,28,1
27-02-2023,Aurora,1,430,2,119,102,17,94,55,93,40,53,11
27-03-2021,ImpactTraining,1,903,749,716,574,142,81,0,53,11,42,6
27-03-2021,Mustangs,2,112,90,105,98,7,85,64,55,3,52,4
27-03-2021,Quicksilver,3,940,504,793,58,735,64,53,59,1,58,5
27-03-2021,PrimeSeven,2,428,275,340,264,76,52,9,23,1,22,0
27-03-2021,CelestialInterface,3,632,299,424,113,311,86,15,24,3,21,1
27-03-2021,ImpactTraining,3,128,75,9,0,9,87,2,56,5,51,6
27-03-2021,CelestialInterface,2,308,40,227,133,94,89,72,84,49,35,8
27-03-2021,GrayPanthers,1,395,134,228,170,58,84,41,50,25,25,2
27-03-2021,ImpactTraining,3,543,295,244,194,50,54,6,29,28,1,0
27-03-2022,Aurora,3,364,293,80,57,23,51,16,1,0,1,0
27-03-2022,Honeycomb,1,118,13,63,18,45,100,71,55,46,9,3
27-03-2022,BitterLaser,2,867,368,147,46,101,71,66,17,13,4,1
27-03-2022,Quicksilver,1,166,61,74,62,12,82,14,6,2,4,0
27-03-2022,ImpactTraining,1,144,47,10,5,5,76,13,16,12,4,0
27-03-2022,ImpactTraining,3,690,279,148,45,103,88,46,14,3,11,0
27-03-2022,GrayPanthers,3,689,138,530,321,209,50,9,12,11,1,0
27-03-2022,Discovery,3,274,172,215,105,110,60,34,39,5,34,2
27-03-2022,ImpactTraining,2,655,272,11,0,11,56,6,28,1,27,3
27-03-2023,BitterLaser,2,567,274,494,132,362,79,50,32,22,10,3
27-03-2023,Aurora,3,952,521,805,38,767,54,14,27,2,25,1
27-03-2023,BitterLaser,1,230,95,104,12,92,56,55,6,4,2,0
27-03-2023,Aurora,2,829,6,435,337,98,84,4,29,23,6,0
27-03-2023,PrimeSeven,2,304,211,145,17,128,68,36,25,17,8,1
27-03-2023,ImpactTraining,3,505,163,140,15,125,97,26,57,1,56,3
27-03-2023,Mustangs,3,577,183,516,256,260,59,13,2,1,1,0
27-03-2023,BitterLaser,2,299,62,60,13,47,57,54,39,11,28,4
27-03-2023,Mustangs,1,588,302,358,25,333,81,33,36,18,18,3
27-03-2023,ImpactTraining,2,585,379,421,122,299,94,56,21,13,8,0
27-03-2023,GrayPanthers,1,522,413,46,17,29,67,49,34,27,7,2
27-03-2023,GrayPanthers,1,135,74,96,22,74,72,11,4,1,3,0
27-03-2023,PrimeSeven,3,176,157,50,26,24,100,45,11,2,9,0
27-04-2021,PrimeSeven,1,165,128,105,89,16,82,10,61,52,9,5
27-04-2021,Mustangs,1,935,688,167,140,27,81,2,32,28,4,1
27-04-2021,PrimeSeven,1,170,4,106,58,48,73,55,5,4,1,0
27-04-2021,CelestialInterface,1,504,264,236,232,4,75,69,50,29,21,4
27-04-2022,Aurora,2,856,667,207,40,167,73,33,49,22,27,6
27-04-2022,CelestialInterface,2,247,208,63,14,49,64,28,27,24,3,3
27-04-2022,Quicksilver,2,284,99,39,14,25,93,49,73,49,24,7
27-04-2022,PrimeSeven,1,292,6,20,14,6,50,0,16,4,12,1
27-04-2022,ImpactTraining,1,740,143,694,417,277,72,58,33,1,32,2
27-04-2022,Discovery,2,709,508,68,50,18,96,80,3,2,1,0
27-04-2022,Quicksilver,3,532,49,130,63,67,79,62,11,1,10,0
27-04-2023,ImpactTraining,1,804,105,573,214,359,84,51,29,16,13,2
27-04-2023,PrimeSeven,1,359,267,110,105,5,58,44,51,38,13,3
27-04-2023,GrayPanthers,2,367,254,78,16,62,51,1,12,11,1,0
27-04-2023,ImpactTraining,2,653,522,597,134,463,71,17,35,12,23,3
27-05-2021,CelestialInterface,3,571,235,334,71,263,90,12,16,8,8,0
27-05-2021,GrayPanthers,3,300,44,266,30,236,53,52,46,31,15,1
27-05-2021,Aurora,3,343,190,209,7,202,91,57,16,7,9,0
27-05-2021,Honeycomb,2,999,614,564,68,496,61,43,8,2,6,0
27-05-2021,Aurora,3,303,109,237,65,172,58,3,38,4,34,0
27-05-2022,Mustangs,1,157,51,57,11,46,74,69,31,19,12,3
27-05-2022,GrayPanthers,3,390,266,178,128,50,70,45,29,14,15,0
27-05-2022,Honeycomb,2,841,763,577,359,218,65,23,21,14,7,2
27-05-2022,Discovery,1,828,286,229,30,199,72,22,51,21,30,1
27-05-2022,BitterLaser,2,449,345,5,4,1,81,26,24,7,17,0
27-05-2022,PrimeSeven,1,982,540,604,11,593,55,52,23,6,17,1
27-05-2022,Quicksilver,3,937,382,64,19,45,63,61,51,35,16,1
27-05-2022,CelestialInterface,1,456,15,204,169,35,55,47,27,17,10,2
27-05-2022,PrimeSeven,1,816,110,576,277,299,87,60,47,31,16,2
27-05-2022,BitterLaser,1,627,279,167,58,109,90,1,65,36,29,8
27-05-2022,Honeycomb,3,805,457,128,44,84,88,59,75,25,50,4
27-05-2022,BitterLaser,2,706,357,139,138,1,93,12,13,1,12,0
27-05-2022,Aurora,2,184,53,91,54,37,90,55,9,2,7,0
27-05-2022,Quicksilver,1,521,375,367,286,81,62,20,52,39,13,4
27-05-2022,ImpactTraining,3,522,104,258,1,257,81,45,10,2,8,0
27-05-2022,Honeycomb,1,285,196,225,153,72,59,17,46,44,2,1
27-05-2023,PrimeSeven,3,628,270,125,21,104,58,26,1,0,1,0
27-05-2023,Mustangs,2,877,814,337,49,288,62,55,40,20,20,2
27-05-2023,BitterLaser,2,316,219,87,27,60,68,1,25,10,15,1
27-05-2023,BitterLaser,1,619,168,48,41,7,94,34,24,23,1,2
27-05-2023,CelestialInterface,2,881,92,137,12,125,70,66,31,2,29,3
27-05-2023,Mustangs,2,460,154,314,96,218,60,24,0,0,0,0
27-05-2023,Honeycomb,1,990,921,553,7,546,94,31,86,39,47,3
27-05-2023,Quicksilver,3,359,22,269,132,137,60,43,13,2,11,0
27-06-2021,CelestialInterface,3,628,619,279,166,113,87,11,3,2,1,0
27-06-2021,Quicksilver,2,585,171,192,87,105,68,1,2,0,2,0
27-06-2021,BitterLaser,3,706,340,539,79,460,57,44,36,0,36,4
27-06-2021,Mustangs,1,395,100,223,208,15,86,78,20,18,2,1
27-06-2022,ImpactTraining,3,622,20,8,1,7,58,45,30,6,24,2
27-06-2022,BitterLaser,3,165,68,61,0,61,99,29,33,15,18,2
27-06-2022,Mustangs,1,641,4,166,102,64,93,16,17,0,17,1
27-06-2023,ImpactTraining,2,704,226,504,398,106,61,50,54,1,53,2
27-06-2023,Quicksilver,3,185,111,119,91,28,54,12,1,0,1,0
27-06-2023,GrayPanthers,2,543,171,221,165,56,83,36,5,0,5,0
27-06-2023,Discovery,2,945,691,745,500,245,73,60,64,12,52,5
27-06-2023,GrayPanthers,3,564,361,446,319,127,84,0,16,9,7,0
27-06-2023,CelestialInterface,1,944,234,327,53,274,73,48,16,9,7,0
27-06-2023,ImpactTraining,1,497,195,56,44,12,62,10,14,6,8,1
27-06-2023,Quicksilver,1,706,380,515,28,487,63,33,13,0,13,0
27-06-2023,Discovery,3,550,290,446,375,71,90,14,52,24,28,0
27-07-2021,Discovery,3,267,83,153,4,149,78,52,32,26,6,1
27-07-2021,GrayPanthers,1,727,718,530,453,77,86,84,54,2,52,2
27-07-2021,ImpactTraining,1,480,440,288,61,227,66,55,34,0,34,1
27-07-2021,Mustangs,3,310,28,248,72,176,86,38,71,67,4,7
27-07-2021,Honeycomb,3,594,431,490,482,8,52,35,33,6,27,0
27-07-2021,Discovery,1,388,102,115,42,73,72,3,36,2,34,2
27-07-2021,Discovery,1,753,663,643,38,605,51,26,13,2,11,0
27-07-2022,ImpactTraining,1,769,399,347,9,338,86,66,19,18,1,0
27-07-2022,Quicksilver,2,886,756,226,29,197,63,6,62,28,34,6
27-07-2022,GrayPanthers,2,950,261,519,363,156,72,67,56,51,5,2
27-07-2022,ImpactTraining,1,558,365,220,76,144,95,90,82,56,26,6
27-07-2022,BitterLaser,3,432,268,329,210,119,76,47,0,0,0,0
27-07-2022,CelestialInterface,3,567,517,241,27,214,98,70,94,73,21,6
27-07-2022,Discovery,1,563,488,443,52,391,95,25,65,29,36,6
27-07-2022,BitterLaser,3,383,177,210,35,175,68,34,41,10,31,4
27-07-2022,Mustangs,1,448,180,299,81,218,84,73,66,43,23,6
27-07-2023,ImpactTraining,3,518,131,276,134,142,54,33,28,15,13,0
27-07-2023,BitterLaser,3,479,366,189,169,20,92,66,53,10,43,4
27-07-2023,CelestialInterface,1,753,115,175,40,135,50,40,18,7,11,0
27-07-2023,Mustangs,2,783,501,713,182,531,77,60,18,12,6,0
27-07-2023,CelestialInterface,1,269,251,65,57,8,90,38,48,41,7,5
27-07-2023,CelestialInterface,2,186,51,161,16,145,54,34,31,6,25,1
27-07-2023,Aurora,3,424,249,405,78,327,73,53,26,21,5,1
27-08-2021,Mustangs,1,576,551,523,92,431,72,59,55,9,46,6
27-08-2021,GrayPanthers,1,743,684,13,6,7,78,51,13,5,8,0
27-08-2021,Aurora,2,697,442,4,1,3,50,49,21,5,16,1
27-08-2021,Quicksilver,3,607,315,72,68,4,68,26,58,39,19,0
27-08-2021,Honeycomb,3,223,140,214,200,14,51,4,44,41,3,1
27-08-2021,BitterLaser,3,351,113,86,39,47,80,58,74,61,13,3
27-08-2022,ImpactTraining,3,844,622,274,76,198,95,11,45,44,1,2
27-08-2022,Mustangs,1,393,138,16,4,12,57,34,10,4,6,0
27-08-2022,Honeycomb,2,194,62,140,75,65,69,59,63,46,17,8
27-08-2022,Aurora,2,478,1,95,26,69,53,38,21,3,18,0
27-08-2022,GrayPanthers,2,424,344,298,242,56,61,39,36,28,8,1
27-08-2022,CelestialInterface,2,210,62,209,14,195,94,22,46,23,23,4
27-08-2023,ImpactTraining,2,914,91,204,82,122,90,9,64,24,40,7
27-08-2023,PrimeSeven,3,684,331,582,182,400,57,24,48,10,38,0
27-08-2023,PrimeSeven,1,913,902,347,243,104,63,14,28,17,11,1
27-08-2023,Quicksilver,1,706,83,251,30,221,83,37,76,67,9,0
27-08-2023,PrimeSeven,2,881,126,742,472,270,93,60,88,6,82,4
27-08-2023,BitterLaser,3,432,417,393,11,382,57,46,13,11,2,0
27-09-2021,GrayPanthers,3,449,448,122,3,119,94,49,75,29,46,9
27-09-2021,CelestialInterface,2,334,271,212,43,169,86,83,72,20,52,0
27-09-2021,Honeycomb,3,420,217,101,37,64,63,52,56,25,31,6
27-09-2021,PrimeSeven,3,238,166,45,40,5,53,11,35,32,3,1
27-09-2021,Quicksilver,3,888,186,556,499,57,53,27,46,29,17,4
27-09-2021,ImpactTraining,3,626,472,499,172,327,94,53,76,40,36,8
27-09-2021,BitterLaser,2,844,264,731,622,109,61,5,22,6,16,1
27-09-2021,Mustangs,1,811,70,36,0,36,69,50,68,67,1,6
27-09-2021,GrayPanthers,3,352,42,103,56,47,53,7,35,29,6,4
27-09-2021,Honeycomb,2,991,445,861,278,583,61,32,47,36,11,3
27-09-2021,BitterLaser,1,749,367,374,145,229,52,33,27,24,3,2
27-09-2021,ImpactTraining,2,278,76,68,1,67,53,11,17,16,1,1
27-09-2021,CelestialInterface,1,311,54,281,45,236,88,49,55,38,17,4
27-09-2022,GrayPanthers,3,348,205,59,41,18,93,86,37,13,24,0
27-09-2022,Aurora,2,639,559,152,70,82,50,12,41,26,15,2
27-09-2022,BitterLaser,1,284,225,43,2,41,81,50,34,32,2,4
27-09-2022,Aurora,2,168,151,11,9,2,76,61,47,28,19,5
27-09-2022,GrayPanthers,2,136,58,47,34,13,55,34,16,10,6,0
27-09-2022,Quicksilver,3,526,51,413,325,88,96,41,12,1,11,0
27-09-2023,ImpactTraining,1,689,183,340,137,203,75,52,22,0,22,1
27-09-2023,Quicksilver,2,585,6,488,262,226,88,25,20,12,8,1
27-09-2023,PrimeSeven,3,458,354,215,79,136,98,3,29,22,7,1
27-09-2023,Honeycomb,1,628,547,323,243,80,100,43,42,31,11,4
27-09-2023,Aurora,1,528,219,501,155,346,51,44,26,8,18,1
27-09-2023,PrimeSeven,2,345,286,91,0,91,52,34,42,27,15,1
27-09-2023,CelestialInterface,2,860,654,591,318,273,54,33,8,1,7,0
27-10-2021,CelestialInterface,1,245,195,157,3,154,86,61,58,56,2,7
27-10-2021,Discovery,2,380,39,283,124,159,76,58,23,8,15,0
27-10-2021,CelestialInterface,2,249,191,8,1,7,57,22,24,9,15,0
27-10-2021,PrimeSeven,1,571,291,304,139,165,62,20,34,29,5,1
27-10-2021,PrimeSeven,3,587,483,535,415,120,56,25,23,2,21,1
27-10-2021,CelestialInterface,1,485,309,448,221,227,81,54,32,0,32,0
27-10-2021,Quicksilver,2,195,19,157,137,20,51,15,27,26,1,2
27-10-2021,Honeycomb,1,920,10,203,132,71,60,59,29,20,9,0
27-10-2022,Aurora,2,540,58,510,21,489,98,40,51,34,17,4
27-10-2022,GrayPanthers,1,947,520,456,107,349,88,31,23,7,16,0
27-10-2022,Quicksilver,3,171,111,98,48,50,70,8,30,20,10,0
27-10-2022,GrayPanthers,2,895,437,1,0,1,75,42,27,11,16,1
27-10-2022,PrimeSeven,2,432,154,303,4,299,74,46,28,6,22,0
27-10-2022,Mustangs,3,224,203,71,27,44,92,45,46,44,2,4
27-10-2022,Mustangs,3,535,168,227,86,141,94,27,92,73,19,12
27-10-2022,Mustangs,3,205,110,192,3,189,98,46,15,9,6,0
27-10-2022,CelestialInterface,1,760,67,391,255,136,79,76,67,36,31,4
27-10-2022,Honeycomb,1,677,119,232,95,137,57,47,29,7,22,2
27-10-2022,Mustangs,1,792,627,43,23,20,68,44,11,3,8,0
27-10-2023,CelestialInterface,2,293,144,146,31,115,86,75,25,24,1,2
27-10-2023,ImpactTraining,3,926,162,99,45,54,82,20,20,12,8,2
27-10-2023,Aurora,2,825,367,418,267,151,72,24,52,5,47,1
27-10-2023,Quicksilver,2,719,451,618,380,238,63,40,30,23,7,3
27-10-2023,PrimeSeven,1,365,236,317,76,241,72,31,8,7,1,0
27-10-2023,Honeycomb,2,603,358,3,0,3,52,30,44,17,27,1
27-11-2021,Mustangs,1,925,91,868,703,165,84,21,81,62,19,1
27-11-2021,Honeycomb,3,603,375,550,401,149,58,52,8,6,2,0
27-11-2021,CelestialInterface,3,213,141,84,38,46,68,24,63,24,39,8
27-11-2021,CelestialInterface,1,722,219,236,33,203,92,51,25,2,23,0
27-11-2021,ImpactTraining,2,918,706,685,458,227,81,9,67,50,17,3
27-11-2021,Mustangs,1,747,684,550,372,178,77,71,34,4,30,2
27-11-2021,PrimeSeven,2,810,452,172,159,13,58,53,47,33,14,5
27-11-2021,Mustangs,1,915,800,254,153,101,99,62,89,0,89,6
27-11-2021,PrimeSeven,1,270,112,70,12,58,94,51,41,17,24,3
27-11-2021,Honeycomb,1,667,555,410,278,132,61,11,33,0,33,0
27-11-2021,Mustangs,2,409,284,234,104,130,91,0,89,29,60,5
27-11-2021,Mustangs,3,593,111,432,413,19,58,6,48,15,33,6
27-11-2021,Discovery,1,602,80,588,226,362,63,20,24,17,7,1
27-11-2021,CelestialInterface,3,752,76,696,625,71,67,60,58,49,9,2
27-11-2021,CelestialInterface,3,420,71,110,83,27,88,53,11,10,1,0
27-11-2022,Quicksilver,2,292,58,277,37,240,84,17,26,0,26,1
27-11-2022,PrimeSeven,1,407,213,254,102,152,96,49,50,22,28,1
27-11-2022,GrayPanthers,1,439,330,329,103,226,59,31,50,29,21,3
27-11-2022,ImpactTraining,3,411,276,88,72,16,86,25,28,4,24,3
27-11-2022,Honeycomb,3,751,376,229,60,169,84,42,34,27,7,1
27-11-2022,Honeycomb,3,578,161,403,16,387,93,13,55,27,28,0
27-11-2022,ImpactTraining,1,892,91,863,709,154,74,5,39,22,17,1
27-11-2022,Mustangs,3,646,158,70,52,18,78,22,14,7,7,0
27-11-2022,Aurora,1,132,18,122,18,104,87,58,68,13,55,5
27-11-2022,Discovery,1,531,211,216,122,94,81,33,38,13,25,1
27-11-2022,Quicksilver,3,562,400,123,62,61,95,46,61,19,42,1
27-11-2022,Discovery,1,112,102,104,10,94,74,58,33,25,8,1
27-11-2022,Discovery,1,870,122,571,471,100,78,15,55,47,8,3
27-11-2022,CelestialInterface,1,872,325,85,83,2,99,79,13,4,9,0
27-11-2023,Quicksilver,3,341,46,158,120,38,100,73,80,30,50,4
27-11-2023,Quicksilver,3,367,115,257,9,248,76,49,13,8,5,0
27-11-2023,Quicksilver,1,198,16,62,52,10,63,22,25,13,12,2
27-11-2023,GrayPanthers,2,554,391,49,48,1,90,46,7,6,1,0
27-11-2023,ImpactTraining,3,874,764,707,582,125,83,0,70,23,47,0
27-11-2023,Mustangs,3,837,217,648,44,604,67,23,42,26,16,2
27-11-2023,CelestialInterface,1,159,105,28,21,7,60,5,23,9,14,2
27-11-2023,Discovery,3,227,104,125,31,94,83,2,27,14,13,0
27-11-2023,CelestialInterface,2,875,486,404,285,119,58,21,20,17,3,1
27-11-2023,Mustangs,3,304,133,81,23,58,87,80,58,25,33,6
27-11-2023,PrimeSeven,1,341,76,45,36,9,52,26,26,3,23,0
27-12-2021,Discovery,2,403,149,87,33,54,78,1,45,38,7,2
27-12-2021,GrayPanthers,2,376,195,294,81,213,83,51,35,19,16,0
27-12-2021,Honeycomb,2,145,73,60,46,14,95,92,6,0,6,0
27-12-2021,Discovery,1,477,97,93,36,57,75,57,60,53,7,5
27-12-2021,Honeycomb,1,586,171,572,452,120,95,92,93,33,60,11
27-12-2021,GrayPanthers,3,956,656,542,493,49,81,67,63,4,59,6
27-12-2022,PrimeSeven,2,806,380,557,228,329,92,76,89,66,23,7
27-12-2022,Mustangs,2,790,783,128,4,124,92,28,90,61,29,9
27-12-2022,Honeycomb,2,583,492,25,15,10,54,31,10,1,9,0
27-12-2022,Aurora,1,897,309,682,44,638,88,37,46,28,18,4
27-12-2022,ImpactTraining,3,886,606,194,128,66,69,42,39,26,13,3
27-12-2022,Aurora,1,363,172,232,65,167,60,39,58,50,8,6
27-12-2022,Mustangs,1,106,83,101,13,88,82,68,37,23,14,0
27-12-2022,CelestialInterface,2,111,35,27,15,12,53,18,50,41,9,0
27-12-2022,PrimeSeven,2,544,150,138,29,109,80,21,74,44,30,6
27-12-2022,BitterLaser,2,185,145,18,11,7,78,44,24,20,4,1
27-12-2022,Aurora,2,927,284,307,50,257,50,23,39,37,2,1
27-12-2022,Discovery,1,663,159,196,138,58,86,78,9,5,4,0
27-12-2023,ImpactTraining,1,847,492,636,361,275,71,6,57,23,34,1
27-12-2023,CelestialInterface,2,922,908,473,388,85,68,67,56,12,44,5
27-12-2023,ImpactTraining,3,791,614,62,0,62,71,64,39,23,16,2
27-12-2023,BitterLaser,3,759,163,10,6,4,80,41,2,0,2,0
27-12-2023,Mustangs,2,501,177,68,58,10,96,16,13,0,13,0
28-01-2021,ImpactTraining,1,254,56,0,0,0,86,34,71,37,34,1
28-01-2021,Discovery,1,705,419,225,65,160,95,90,32,2,30,0
28-01-2021,CelestialInterface,3,482,29,367,325,42,59,48,29,10,19,0
28-01-2021,GrayPanthers,1,792,267,455,342,113,73,40,54,47,7,0
28-01-2021,GrayPanthers,1,174,160,160,107,53,88,68,10,2,8,0
28-01-2021,Aurora,2,284,191,216,127,89,97,0,70,40,30,1
28-01-2021,Quicksilver,3,411,377,189,139,50,75,38,44,9,35,4
28-01-2021,BitterLaser,1,586,267,364,70,294,74,1,28,10,18,1
28-01-2021,GrayPanthers,2,277,232,78,12,66,57,5,44,4,40,3
28-01-2021,GrayPanthers,2,346,185,218,199,19,74,1,12,1,11,0
28-01-2021,PrimeSeven,1,836,648,600,575,25,92,73,81,72,9,3
28-01-2022,Discovery,3,168,8,129,47,82,52,48,25,2,23,2
28-01-2022,ImpactTraining,1,514,413,307,142,165,65,44,39,19,20,4
28-01-2022,Discovery,2,337,238,217,211,6,87,27,82,4,78,3
28-01-2022,Discovery,3,697,513,350,88,262,56,6,21,18,3,1
28-01-2022,ImpactTraining,1,681,643,443,256,187,70,47,34,28,6,2
28-01-2022,Honeycomb,2,872,547,87,33,54,89,61,22,4,18,0
28-01-2022,CelestialInterface,2,897,764,339,259,80,85,19,13,5,8,0
28-01-2022,GrayPanthers,3,195,77,81,33,48,80,26,21,1,20,2
28-01-2022,BitterLaser,3,310,299,129,113,16,57,18,36,24,12,0
28-01-2022,Honeycomb,3,526,169,438,356,82,79,7,59,28,31,3
28-01-2022,Mustangs,2,655,143,575,503,72,87,2,17,4,13,0
28-01-2022,Quicksilver,2,697,398,130,48,82,59,2,40,36,4,0
28-01-2022,Quicksilver,2,530,520,40,21,19,75,65,8,6,2,0
28-01-2022,Aurora,2,912,673,701,115,586,64,60,37,20,17,2
28-01-2022,CelestialInterface,3,423,244,187,179,8,63,47,31,26,5,1
28-01-2022,PrimeSeven,3,732,464,273,259,14,55,17,53,24,29,0
28-01-2022,PrimeSeven,1,315,124,270,87,183,98,14,37,9,28,4
28-01-2022,GrayPanthers,2,863,241,431,291,140,91,13,68,8,60,2
28-01-2022,Mustangs,2,644,174,555,190,365,51,19,24,23,1,0
28-01-2023,Mustangs,1,590,502,518,229,289,62,5,58,51,7,5
28-01-2023,GrayPanthers,1,518,235,32,13,19,74,33,7,3,4,0
28-01-2023,Mustangs,1,586,425,123,34,89,85,41,9,6,3,0
28-01-2023,ImpactTraining,2,180,153,133,62,71,86,50,0,0,0,0
28-01-2023,PrimeSeven,1,340,260,10,0,10,62,7,8,5,3,0
28-01-2023,GrayPanthers,1,781,384,593,210,383,58,35,39,3,36,2
28-01-2023,Quicksilver,3,611,236,408,88,320,63,61,50,28,22,2
28-02-2021,BitterLaser,3,585,531,115,112,3,55,5,47,39,8,3
28-02-2021,PrimeSeven,3,657,615,299,153,146,51,0,27,24,3,2
28-02-2021,BitterLaser,1,726,6,113,2,111,96,4,39,34,5,2
28-02-2021,Quicksilver,2,752,10,735,296,439,91,80,90,13,77,10
28-02-2021,ImpactTraining,2,579,215,301,45,256,74,12,55,43,12,6
28-02-2021,CelestialInterface,3,208,155,191,7,184,56,20,50,25,25,6
28-02-2021,Aurora,1,699,636,535,515,20,53,19,32,5,27,0
28-02-2021,CelestialInterface,3,706,525,619,260,359,63,31,50,41,9,2
28-02-2021,Aurora,3,223,221,167,92,75,65,4,18,7,11,0
28-02-2021,BitterLaser,3,244,198,49,34,15,56,36,28,12,16,0
28-02-2021,Honeycomb,2,378,32,247,190,57,53,34,52,23,29,5
28-02-2021,GrayPanthers,1,200,109,167,70,97,83,70,69,30,39,5
28-02-2022,Aurora,3,602,257,361,317,44,69,51,60,39,21,1
28-02-2022,GrayPanthers,2,516,480,41,13,28,81,57,71,23,48,6
28-02-2022,Aurora,2,348,92,239,180,59,78,43,10,5,5,0
28-02-2022,PrimeSeven,3,759,105,109,37,72,72,20,67,4,63,3
28-02-2022,Honeycomb,2,678,406,459,318,141,81,28,47,13,34,6
28-02-2022,GrayPanthers,1,201,56,192,31,161,99,37,93,71,22,11
28-02-2022,Honeycomb,1,409,76,168,42,126,67,20,22,21,1,2
28-02-2023,Discovery,1,988,697,544,170,374,55,45,21,15,6,1
28-02-2023,PrimeSeven,2,258,235,43,29,14,96,62,26,5,21,2
28-02-2023,ImpactTraining,1,744,342,453,83,370,71,25,14,1,13,1
28-02-2023,PrimeSeven,3,651,104,360,192,168,97,21,92,3,89,2
28-02-2023,BitterLaser,1,749,86,522,134,388,87,44,30,15,15,2
28-02-2023,PrimeSeven,1,968,70,405,379,26,65,2,56,50,6,7
28-02-2023,Quicksilver,3,182,93,108,4,104,59,51,19,16,3,0
28-02-2023,Mustangs,2,750,640,635,277,358,64,37,44,20,24,5
28-03-2021,GrayPanthers,1,302,31,92,71,21,55,45,52,23,29,5
28-03-2021,Aurora,1,791,437,731,576,155,83,16,40,9,31,2
28-03-2021,ImpactTraining,1,161,39,2,1,1,59,45,1,0,1,0
28-03-2021,BitterLaser,2,784,710,581,396,185,82,29,28,12,16,2
28-03-2021,GrayPanthers,1,529,464,65,37,28,52,37,3,0,3,0
28-03-2022,BitterLaser,3,713,102,613,520,93,68,40,11,10,1,0
28-03-2022,BitterLaser,1,136,106,83,67,16,51,47,11,8,3,0
28-03-2022,Quicksilver,1,106,80,71,1,70,68,63,36,21,15,0
28-03-2022,PrimeSeven,2,544,491,218,184,34,52,25,26,7,19,1
28-03-2022,PrimeSeven,2,892,484,461,170,291,67,47,64,31,33,2
28-03-2022,Quicksilver,1,733,644,628,603,25,90,77,49,4,45,1
28-03-2023,Honeycomb,2,258,37,95,78,17,77,54,65,2,63,1
28-03-2023,BitterLaser,3,278,46,191,64,127,69,26,18,7,11,1
28-03-2023,BitterLaser,1,914,497,243,235,8,74,31,4,3,1,0
28-03-2023,GrayPanthers,1,531,7,271,265,6,91,28,83,30,53,10
28-03-2023,ImpactTraining,3,156,110,68,19,49,69,42,68,16,52,7
28-03-2023,Discovery,2,766,729,57,12,45,63,53,34,10,24,3
28-04-2021,GrayPanthers,2,634,115,329,261,68,100,54,62,57,5,3
28-04-2021,ImpactTraining,3,870,624,620,255,365,97,46,62,6,56,6
28-04-2021,BitterLaser,1,837,409,732,361,371,50,19,20,12,8,0
28-04-2021,BitterLaser,2,126,90,5,0,5,99,60,8,1,7,0
28-04-2021,ImpactTraining,1,412,3,102,27,75,79,22,70,24,46,6
28-04-2021,GrayPanthers,3,372,168,54,3,51,59,42,2,1,1,0
28-04-2022,PrimeSeven,1,451,18,446,138,308,91,53,28,20,8,2
28-04-2022,GrayPanthers,1,467,293,391,168,223,80,13,17,8,9,0
28-04-2022,Quicksilver,1,121,94,45,17,28,50,43,47,21,26,6
28-04-2022,GrayPanthers,3,949,489,250,79,171,73,15,64,59,5,3
28-04-2022,Mustangs,3,518,348,135,127,8,76,6,57,2,55,6
28-04-2022,Honeycomb,1,374,14,163,154,9,79,13,56,36,20,4
28-04-2022,BitterLaser,1,414,295,250,29,221,55,46,20,5,15,0
28-04-2022,PrimeSeven,1,394,268,82,57,25,53,22,0,0,0,0
28-04-2022,Quicksilver,1,360,103,257,79,178,63,42,46,13,33,0
28-04-2022,ImpactTraining,3,194,129,53,15,38,55,48,34,8,26,0
28-04-2022,Discovery,2,452,252,442,228,214,59,5,11,3,8,0
28-04-2022,Quicksilver,2,312,289,92,28,64,60,50,28,15,13,3
28-04-2022,CelestialInterface,1,424,161,351,248,103,82,23,6,4,2,0
28-04-2022,Aurora,2,697,420,355,342,13,73,71,56,47,9,2
28-04-2023,BitterLaser,1,489,230,22,4,18,54,38,6,4,2,0
28-04-2023,BitterLaser,1,765,162,98,28,70,58,2,31,22,9,2
28-04-2023,CelestialInterface,1,244,42,81,18,63,58,9,51,18,33,2
28-04-2023,Discovery,2,527,142,373,301,72,83,34,48,39,9,2
28-04-2023,Mustangs,1,940,653,850,154,696,79,4,24,8,16,2
28-04-2023,BitterLaser,1,972,9,504,328,176,64,29,13,9,4,0
28-04-2023,GrayPanthers,3,790,619,333,293,40,77,27,47,1,46,0
28-04-2023,CelestialInterface,1,602,384,178,105,73,53,6,42,22,20,1
28-04-2023,Quicksilver,3,482,422,178,111,67,92,67,78,16,62,10
28-05-2021,BitterLaser,2,271,74,127,62,65,76,57,10,6,4,0
28-05-2021,BitterLaser,2,999,859,571,548,23,90,1,17,2,15,1
28-05-2021,ImpactTraining,2,872,197,76,1,75,65,51,13,8,5,0
28-05-2021,Quicksilver,3,826,3,234,102,132,51,15,24,13,11,0
28-05-2021,Aurora,2,366,42,196,72,124,98,34,33,15,18,2
28-05-2021,Aurora,2,174,113,121,55,66,60,44,49,29,20,3
28-05-2021,Discovery,2,292,61,210,163,47,81,66,10,7,3,0
28-05-2021,PrimeSeven,1,799,520,350,219,131,67,15,1,0,1,0
28-05-2021,PrimeSeven,3,363,184,120,46,74,78,28,11,8,3,0
28-05-2021,Discovery,1,490,367,289,97,192,96,60,35,5,30,1
28-05-2021,Honeycomb,1,335,187,116,12,104,92,12,59,5,54,3
28-05-2021,Aurora,1,276,241,58,49,9,58,1,4,1,3,0
28-05-2021,GrayPanthers,3,114,25,34,9,25,88,69,11,6,5,0
28-05-2021,GrayPanthers,2,540,113,263,244,19,82,55,69,57,12,0
28-05-2021,BitterLaser,1,279,229,262,77,185,67,39,0,0,0,0
28-05-2022,Quicksilver,2,114,78,14,13,1,73,38,72,42,30,0
28-05-2022,Aurora,1,696,291,517,215,302,64,16,56,49,7,1
28-05-2022,ImpactTraining,2,233,127,172,157,15,92,29,22,11,11,0
28-05-2022,Mustangs,1,754,567,183,66,117,84,6,72,46,26,3
28-05-2022,Aurora,2,205,37,155,131,24,99,60,83,44,39,3
28-05-2022,GrayPanthers,1,637,627,340,151,189,78,26,22,21,1,1
28-05-2022,Mustangs,2,921,624,609,13,596,87,86,85,32,53,4
28-05-2022,Discovery,1,568,178,377,375,2,85,52,27,5,22,2
28-05-2022,Honeycomb,1,427,310,226,142,84,53,29,0,0,0,0
28-05-2022,BitterLaser,2,544,474,225,121,104,51,12,7,0,7,0
28-05-2023,Honeycomb,1,949,69,725,337,388,98,11,16,8,8,1
28-05-2023,GrayPanthers,2,870,239,694,231,463,86,74,62,49,13,6
28-05-2023,GrayPanthers,3,332,136,277,219,58,87,47,17,16,1,0
28-05-2023,PrimeSeven,3,668,219,198,188,10,96,87,26,16,10,2
28-05-2023,BitterLaser,2,966,671,718,128,590,53,6,30,20,10,3
28-06-2021,Aurora,2,202,143,78,8,70,67,61,34,31,3,3
28-06-2021,BitterLaser,2,660,192,22,9,13,64,33,37,19,18,2
28-06-2021,Aurora,1,514,167,482,327,155,86,69,60,17,43,2
28-06-2021,GrayPanthers,1,105,24,33,9,24,91,70,15,6,9,1
28-06-2021,Quicksilver,1,772,212,96,88,8,67,16,32,30,2,0
28-06-2021,Aurora,2,135,78,99,12,87,87,50,25,4,21,1
28-06-2021,GrayPanthers,3,111,76,3,1,2,61,9,6,1,5,0
28-06-2021,PrimeSeven,2,984,23,15,10,5,93,30,42,31,11,2
28-06-2021,ImpactTraining,1,834,62,504,31,473,58,3,6,5,1,0
28-06-2022,Honeycomb,2,401,49,247,150,97,81,74,64,15,49,4
28-06-2022,Honeycomb,2,632,209,429,244,185,88,43,20,10,10,0
28-06-2022,Discovery,2,171,126,1,0,1,50,47,35,23,12,2
28-06-2022,Quicksilver,2,705,58,256,132,124,98,95,10,3,7,0
28-06-2022,ImpactTraining,2,532,202,453,396,57,66,51,53,35,18,4
28-06-2022,CelestialInterface,2,635,378,436,357,79,85,7,81,73,8,2
28-06-2022,Aurora,2,112,27,7,6,1,59,46,53,51,2,3
28-06-2022,Discovery,2,171,27,134,71,63,95,18,9,6,3,0
28-06-2023,GrayPanthers,1,422,206,202,50,152,85,29,1,0,1,0
28-06-2023,Mustangs,1,912,838,765,127,638,50,0,18,4,14,0
28-06-2023,Aurora,3,547,241,427,22,405,80,16,51,41,10,4
28-06-2023,Discovery,1,379,258,159,77,82,88,3,64,8,56,1
28-06-2023,CelestialInterface,1,222,156,52,38,14,75,72,21,17,4,0
28-06-2023,Mustangs,1,577,157,211,93,118,73,18,63,50,13,7
28-06-2023,PrimeSeven,1,313,149,94,31,63,74,44,28,25,3,3
28-06-2023,CelestialInterface,3,491,7,188,25,163,83,43,15,4,11,0
28-06-2023,BitterLaser,2,815,567,110,64,46,56,36,15,11,4,1
28-06-2023,Discovery,3,909,760,396,88,308,71,51,45,9,36,0
28-07-2021,Quicksilver,3,494,414,475,40,435,85,28,47,31,16,6
28-07-2021,Quicksilver,3,120,2,107,87,20,94,48,50,31,19,0
28-07-2021,Discovery,2,616,352,261,97,164,91,85,53,13,40,6
28-07-2021,ImpactTraining,2,862,634,281,128,153,86,5,66,60,6,7
28-07-2021,Quicksilver,1,132,80,39,23,16,54,51,39,4,35,0
28-07-2021,GrayPanthers,3,421,361,29,7,22,51,3,20,1,19,0
28-07-2021,GrayPanthers,1,635,552,307,100,207,58,20,12,0,12,0
28-07-2021,CelestialInterface,2,543,467,103,50,53,91,88,51,30,21,5
28-07-2021,Quicksilver,1,333,243,64,16,48,63,7,54,21,33,3
28-07-2021,Mustangs,1,959,96,596,273,323,56,18,39,23,16,2
28-07-2021,Discovery,1,781,484,578,243,335,92,83,32,27,5,1
28-07-2022,Quicksilver,2,344,223,298,173,125,89,46,49,17,32,3
28-07-2022,Quicksilver,2,749,511,673,112,561,87,61,56,49,7,6
28-07-2022,Aurora,2,393,31,115,46,69,79,46,58,49,9,2
28-07-2022,GrayPanthers,3,149,17,10,1,9,99,18,64,31,33,7
28-07-2022,Mustangs,3,415,295,248,53,195,59,33,28,25,3,3
28-07-2022,Mustangs,3,365,98,251,163,88,51,19,48,25,23,4
28-07-2022,Mustangs,2,223,98,201,60,141,59,2,39,33,6,2
28-07-2022,BitterLaser,1,898,358,865,70,795,68,56,27,16,11,2
28-07-2022,BitterLaser,1,319,5,90,53,37,62,3,8,1,7,0
28-07-2022,Quicksilver,3,801,272,549,429,120,84,24,11,4,7,0
28-07-2022,Discovery,3,821,559,648,9,639,95,23,75,66,9,1
28-07-2022,PrimeSeven,1,385,301,367,348,19,69,37,34,30,4,4
28-07-2022,PrimeSeven,2,935,131,293,134,159,92,19,87,78,9,1
28-07-2023,Aurora,1,737,173,321,66,255,69,24,6,2,4,0
28-07-2023,GrayPanthers,1,528,187,516,61,455,60,54,49,46,3,1
28-07-2023,CelestialInterface,2,404,324,378,272,106,69,49,61,15,46,5
28-07-2023,Quicksilver,3,183,173,79,70,9,68,7,26,7,19,2
28-07-2023,GrayPanthers,2,629,484,423,77,346,64,23,48,19,29,4
28-07-2023,GrayPanthers,2,302,238,171,17,154,87,62,78,43,35,2
28-08-2021,PrimeSeven,3,742,39,341,5,336,73,25,44,39,5,2
28-08-2021,Honeycomb,2,814,489,634,392,242,84,54,19,11,8,0
28-08-2021,CelestialInterface,2,940,260,719,141,578,66,44,63,59,4,1
28-08-2021,GrayPanthers,3,783,527,286,203,83,63,1,37,15,22,3
28-08-2021,PrimeSeven,1,232,46,43,37,6,55,29,9,4,5,0
28-08-2021,Quicksilver,1,610,456,301,207,94,78,4,52,51,1,4
28-08-2021,GrayPanthers,2,419,137,298,76,222,80,25,58,39,19,1
28-08-2021,Aurora,1,263,128,20,15,5,52,0,16,7,9,0
28-08-2022,CelestialInterface,3,804,55,244,118,126,60,23,23,15,8,2
28-08-2022,Discovery,3,215,141,65,43,22,59,51,43,36,7,3
28-08-2022,Quicksilver,1,555,74,230,228,2,85,9,29,17,12,1
28-08-2022,Discovery,3,956,730,855,412,443,70,68,51,11,40,4
28-08-2022,BitterLaser,3,215,196,11,5,6,50,35,22,10,12,0
28-08-2022,Mustangs,3,154,58,22,8,14,54,11,22,17,5,1
28-08-2023,Discovery,2,322,321,314,164,150,68,64,40,30,10,3
28-08-2023,Mustangs,3,284,206,30,19,11,58,44,45,9,36,2
28-08-2023,BitterLaser,2,730,564,81,72,9,90,82,71,23,48,0
28-08-2023,Aurora,2,400,46,45,7,38,88,28,33,18,15,1
28-08-2023,GrayPanthers,1,434,352,26,2,24,61,27,4,3,1,0
28-08-2023,Mustangs,2,900,735,177,156,21,67,11,23,20,3,1
28-08-2023,Honeycomb,2,213,157,154,44,110,78,61,66,47,19,5
28-08-2023,Mustangs,1,628,619,350,295,55,99,71,77,74,3,6
28-08-2023,Mustangs,1,352,264,53,49,4,85,80,73,35,38,3
28-09-2021,Quicksilver,2,850,635,759,408,351,91,85,65,7,58,8
28-09-2021,ImpactTraining,3,582,506,425,58,367,71,57,12,2,10,0
28-09-2021,Mustangs,3,729,438,85,72,13,92,14,2,1,1,0
28-09-2021,Honeycomb,2,336,244,24,22,2,90,29,12,1,11,0
28-09-2021,GrayPanthers,2,308,183,262,19,243,51,43,42,8,34,2
28-09-2021,Mustangs,2,580,575,361,166,195,73,24,56,47,9,2
28-09-2021,PrimeSeven,1,713,572,590,524,66,50,28,4,3,1,0
28-09-2021,GrayPanthers,3,153,62,39,17,22,50,41,40,7,33,1
28-09-2021,PrimeSeven,2,804,575,202,192,10,54,43,17,9,8,1
28-09-2021,ImpactTraining,3,657,228,258,8,250,64,38,1,0,1,0
28-09-2022,Discovery,1,240,75,0,0,0,94,8,38,10,28,0
28-09-2022,ImpactTraining,3,289,145,118,52,66,91,64,13,12,1,0
28-09-2022,Mustangs,1,235,65,23,3,20,95,85,0,0,0,0
28-09-2022,BitterLaser,1,312,59,135,128,7,72,24,3,0,3,0
28-09-2022,Discovery,1,286,65,281,70,211,66,47,58,30,28,7
28-09-2022,Discovery,2,586,80,134,126,8,71,69,36,32,4,4
28-09-2022,ImpactTraining,2,333,127,27,7,20,74,23,73,56,17,7
28-09-2022,PrimeSeven,1,586,565,410,236,174,66,17,40,14,26,2
28-09-2022,PrimeSeven,3,977,732,92,51,41,57,43,23,21,2,0
28-09-2022,Quicksilver,2,994,252,867,411,456,79,66,9,7,2,0
28-09-2023,Aurora,3,568,183,416,366,50,93,90,88,75,13,12
28-09-2023,CelestialInterface,3,416,304,219,183,36,83,47,7,5,2,0
28-09-2023,Discovery,1,503,495,335,5,330,55,42,27,8,19,2
28-09-2023,CelestialInterface,2,440,234,418,116,302,94,61,28,22,6,3
28-09-2023,BitterLaser,1,100,37,25,23,2,57,15,38,37,1,4
28-09-2023,Honeycomb,1,519,282,282,51,231,92,3,56,31,25,0
28-09-2023,Quicksilver,1,419,183,221,63,158,82,12,51,11,40,0
28-09-2023,Mustangs,2,192,100,32,30,2,77,60,2,1,1,0
28-10-2021,GrayPanthers,3,210,181,206,26,180,95,78,65,10,55,0
28-10-2021,Aurora,3,527,245,154,148,6,64,18,19,2,17,1
28-10-2021,Aurora,2,326,177,75,66,9,90,24,26,14,12,1
28-10-2021,PrimeSeven,2,196,170,170,115,55,76,0,25,18,7,0
28-10-2021,Aurora,3,731,26,652,78,574,68,33,23,17,6,0
28-10-2021,Aurora,1,645,548,163,8,155,64,15,15,14,1,1
28-10-2021,CelestialInterface,1,403,249,113,84,29,59,7,22,19,3,1
28-10-2021,BitterLaser,3,328,308,224,77,147,53,44,2,0,2,0
28-10-2021,GrayPanthers,1,105,15,0,0,0,56,42,50,0,50,5
28-10-2021,Honeycomb,3,253,118,129,71,58,61,26,35,24,11,3
28-10-2021,Honeycomb,1,123,15,4,0,4,86,49,52,33,19,4
28-10-2021,BitterLaser,3,773,389,551,384,167,97,48,5,3,2,0
28-10-2022,PrimeSeven,2,555,546,34,31,3,51,46,20,3,17,1
28-10-2022,Mustangs,2,841,483,639,469,170,81,13,36,7,29,1
28-10-2023,CelestialInterface,2,541,38,102,33,69,96,38,40,39,1,1
28-10-2023,Mustangs,1,988,358,791,67,724,58,32,33,17,16,2
28-10-2023,Mustangs,3,738,61,66,53,13,50,12,44,41,3,1
28-10-2023,CelestialInterface,3,726,156,529,70,459,89,6,63,22,41,7
28-10-2023,Mustangs,1,617,500,519,248,271,78,12,0,0,0,0
28-10-2023,Mustangs,2,511,369,311,267,44,58,42,49,29,20,0
28-11-2021,ImpactTraining,3,351,47,337,72,265,72,36,30,24,6,2
28-11-2021,BitterLaser,1,135,43,104,3,101,59,32,56,24,32,5
28-11-2021,PrimeSeven,3,590,562,83,15,68,87,56,81,64,17,7
28-11-2021,Quicksilver,2,351,139,137,99,38,81,80,53,5,48,1
28-11-2021,Quicksilver,3,246,3,4,3,1,54,15,13,11,2,0
28-11-2021,Quicksilver,3,850,295,362,320,42,86,56,13,12,1,0
28-11-2021,BitterLaser,2,128,85,39,36,3,50,2,27,21,6,0
28-11-2021,Mustangs,1,486,483,226,62,164,78,3,29,24,5,2
28-11-2022,ImpactTraining,3,990,976,149,84,65,95,80,72,28,44,9
28-11-2022,GrayPanthers,1,747,567,90,29,61,94,48,39,33,6,4
28-11-2022,Discovery,3,965,561,351,323,28,81,69,39,7,32,0
28-11-2022,GrayPanthers,1,260,68,78,11,67,52,45,31,2,29,1
28-11-2022,GrayPanthers,3,680,277,574,147,427,58,14,2,0,2,0
28-11-2022,CelestialInterface,3,968,249,574,362,212,79,36,3,0,3,0
28-11-2022,ImpactTraining,1,919,734,821,456,365,89,16,58,31,27,1
28-11-2022,BitterLaser,2,757,399,170,66,104,80,23,54,30,24,4
28-11-2022,Mustangs,3,594,256,561,256,305,75,8,63,50,13,4
28-11-2022,Discovery,1,444,387,335,110,225,64,20,51,27,24,5
28-11-2022,PrimeSeven,3,614,261,57,0,57,89,7,66,57,9,3
28-11-2022,Honeycomb,3,910,762,220,173,47,80,28,77,66,11,7
28-11-2023,Quicksilver,2,437,329,102,101,1,76,12,56,22,34,5
28-11-2023,Aurora,3,648,225,454,291,163,88,22,59,6,53,5
28-11-2023,CelestialInterface,1,357,337,67,19,48,89,58,84,30,54,7
28-11-2023,Mustangs,3,226,21,41,0,41,76,18,57,8,49,6
28-11-2023,BitterLaser,3,423,226,405,142,263,61,36,45,21,24,1
28-12-2021,BitterLaser,3,823,530,237,98,139,71,31,29,9,20,0
28-12-2021,Honeycomb,3,233,23,54,43,11,59,41,55,6,49,0
28-12-2021,Mustangs,1,586,222,383,151,232,82,52,49,27,22,3
28-12-2021,Honeycomb,2,913,206,411,207,204,84,42,23,16,7,2
28-12-2021,CelestialInterface,2,667,441,40,5,35,72,53,6,5,1,0
28-12-2021,Honeycomb,1,925,687,302,72,230,85,68,46,31,15,4
28-12-2021,Quicksilver,2,221,192,179,178,1,56,48,26,12,14,0
28-12-2022,Aurora,2,690,555,242,16,226,96,69,25,7,18,2
28-12-2022,Quicksilver,1,534,105,469,14,455,98,79,48,7,41,4
28-12-2022,CelestialInterface,2,138,46,108,0,108,78,45,38,25,13,1
28-12-2022,BitterLaser,3,722,567,381,220,161,91,33,90,28,62,11
28-12-2022,PrimeSeven,2,786,609,568,153,415,60,46,34,24,10,2
28-12-2022,PrimeSeven,1,841,443,598,399,199,88,20,70,17,53,8
28-12-2022,Discovery,2,902,683,485,93,392,62,36,14,11,3,0
28-12-2022,GrayPanthers,3,1000,346,47,5,42,78,15,9,4,5,0
28-12-2022,PrimeSeven,2,798,351,402,118,284,87,70,37,27,10,2
28-12-2022,CelestialInterface,1,700,438,309,308,1,73,48,11,3,8,0
28-12-2022,Quicksilver,1,222,15,21,2,19,95,36,79,36,43,9
28-12-2022,ImpactTraining,2,525,85,446,13,433,69,42,32,7,25,0
28-12-2022,ImpactTraining,1,363,291,226,216,10,71,28,61,2,59,7
28-12-2023,PrimeSeven,3,463,21,255,254,1,97,89,65,3,62,3
28-12-2023,ImpactTraining,1,829,184,744,72,672,96,89,5,1,4,0
28-12-2023,BitterLaser,2,775,739,13,8,5,71,43,53,7,46,3
28-12-2023,Mustangs,2,505,374,285,247,38,66,34,25,17,8,0
28-12-2023,CelestialInterface,2,626,404,0,0,0,98,10,19,15,4,0
28-12-2023,PrimeSeven,2,186,1,46,3,43,94,92,77,11,66,3
28-12-2023,CelestialInterface,2,186,82,6,5,1,93,49,76,7,69,7
28-12-2023,PrimeSeven,2,954,427,466,156,310,53,9,32,9,23,1
28-12-2023,BitterLaser,1,531,406,528,209,319,79,63,53,51,2,2
28-12-2023,PrimeSeven,2,669,104,86,66,20,57,24,17,3,14,0
29-01-2021,Honeycomb,1,209,60,173,135,38,85,50,63,47,16,1
29-01-2021,ImpactTraining,3,814,339,380,358,22,64,33,30,27,3,2
29-01-2021,Quicksilver,2,237,67,152,48,104,63,7,37,31,6,0
29-01-2021,CelestialInterface,2,298,86,149,10,139,61,36,53,50,3,6
29-01-2021,CelestialInterface,3,564,492,386,143,243,77,20,45,0,45,1
29-01-2021,CelestialInterface,2,819,650,462,140,322,51,43,15,6,9,0
29-01-2021,Quicksilver,2,661,220,51,6,45,86,53,10,6,4,0
29-01-2022,Quicksilver,3,684,414,536,379,157,67,62,63,58,5,0
29-01-2022,PrimeSeven,1,997,275,835,634,201,80,67,28,7,21,2
29-01-2022,Quicksilver,1,632,528,227,27,200,51,20,8,6,2,0
29-01-2022,CelestialInterface,2,544,471,523,107,416,72,3,16,0,16,0
29-01-2022,CelestialInterface,1,411,62,21,10,11,63,44,33,15,18,2
29-01-2022,BitterLaser,1,960,892,417,372,45,56,38,5,4,1,0
29-01-2022,Aurora,2,427,139,214,149,65,58,49,36,22,14,0
29-01-2023,Aurora,1,103,94,40,1,39,86,49,3,1,2,0
29-01-2023,Honeycomb,1,242,131,211,206,5,61,37,39,5,34,1
29-01-2023,PrimeSeven,1,292,169,242,72,170,70,26,65,14,51,3
29-01-2023,Aurora,3,966,302,778,212,566,50,8,31,3,28,1
29-01-2023,Mustangs,1,333,113,266,125,141,61,27,25,16,9,2
29-01-2023,BitterLaser,1,558,531,329,161,168,83,0,76,70,6,3
29-01-2023,Mustangs,2,434,385,112,104,8,59,49,49,28,21,0
29-01-2023,BitterLaser,2,550,408,432,60,372,50,14,13,1,12,0
29-01-2023,Honeycomb,1,661,434,210,70,140,90,82,85,27,58,2
29-01-2023,Discovery,1,515,5,356,325,31,59,12,48,24,24,1
29-01-2023,BitterLaser,1,418,379,338,37,301,86,50,76,53,23,6
29-03-2021,ImpactTraining,1,850,418,55,53,2,72,66,52,24,28,1
29-03-2021,Honeycomb,1,499,344,153,105,48,74,3,9,3,6,0
29-03-2021,Quicksilver,3,396,377,144,80,64,52,17,24,4,20,0
29-03-2021,Discovery,3,249,187,18,14,4,100,7,87,37,50,3
29-03-2021,Mustangs,2,184,101,155,29,126,50,35,31,29,2,2
29-03-2021,PrimeSeven,2,237,223,59,54,5,88,53,20,13,7,2
29-03-2021,GrayPanthers,3,1000,330,383,357,26,62,51,19,6,13,1
29-03-2021,CelestialInterface,3,394,224,129,106,23,93,1,1,0,1,0
29-03-2021,GrayPanthers,3,238,114,0,0,0,85,66,72,60,12,7
29-03-2021,PrimeSeven,1,930,344,675,293,382,90,44,23,0,23,0
29-03-2021,Honeycomb,2,980,401,182,167,15,70,41,10,6,4,0
29-03-2021,Mustangs,1,447,104,48,32,16,79,68,67,27,40,2
29-03-2021,Aurora,1,652,450,585,189,396,97,56,43,27,16,0
29-03-2021,Discovery,1,953,602,750,565,185,69,28,68,32,36,0
29-03-2022,CelestialInterface,3,709,573,582,114,468,77,51,13,10,3,0
29-03-2022,Aurora,3,839,757,289,277,12,57,22,50,17,33,4
29-03-2022,CelestialInterface,1,665,14,253,103,150,85,4,76,42,34,1
29-03-2022,Discovery,1,907,59,284,97,187,98,67,67,49,18,0
29-03-2022,PrimeSeven,3,499,359,35,8,27,95,0,31,7,24,3
29-03-2022,BitterLaser,1,364,243,308,270,38,63,51,42,19,23,4
29-03-2022,ImpactTraining,1,752,85,212,207,5,67,8,25,22,3,1
29-03-2022,Honeycomb,1,856,177,8,2,6,84,45,6,4,2,0
29-03-2022,Mustangs,2,603,238,302,218,84,96,76,84,71,13,1
29-03-2022,Aurora,2,837,701,585,538,47,64,9,25,1,24,0
29-03-2023,BitterLaser,2,131,109,84,47,37,58,51,45,26,19,3
29-03-2023,GrayPanthers,2,486,227,388,151,237,51,4,14,5,9,0
29-03-2023,Quicksilver,3,220,154,160,141,19,64,35,22,13,9,2
29-03-2023,Mustangs,1,108,2,14,8,6,65,34,29,4,25,2
29-03-2023,CelestialInterface,2,753,639,650,324,326,65,1,24,13,11,0
29-03-2023,Quicksilver,2,156,150,99,17,82,89,48,21,3,18,2
29-03-2023,Honeycomb,1,967,113,415,330,85,79,15,53,28,25,4
29-04-2021,Quicksilver,2,519,282,299,265,34,94,16,90,56,34,3
29-04-2021,Honeycomb,2,691,649,581,529,52,65,52,15,7,8,0
29-04-2021,BitterLaser,1,817,753,489,420,69,62,47,16,2,14,1
29-04-2021,PrimeSeven,2,366,115,112,5,107,57,35,23,8,15,0
29-04-2021,CelestialInterface,2,426,377,383,164,219,82,14,10,7,3,0
29-04-2021,Quicksilver,2,815,365,778,11,767,60,57,52,14,38,1
29-04-2021,GrayPanthers,3,989,722,325,61,264,68,1,19,1,18,0
29-04-2021,Quicksilver,2,229,29,70,68,2,75,6,47,25,22,5
29-04-2022,Mustangs,2,708,185,254,160,94,52,21,47,31,16,0
29-04-2022,Honeycomb,2,394,211,60,10,50,91,67,9,1,8,0
29-04-2022,BitterLaser,1,771,35,347,307,40,60,45,14,12,2,0
29-04-2022,BitterLaser,2,142,51,138,135,3,74,18,36,33,3,1
29-04-2022,Discovery,1,983,357,628,27,601,85,14,11,1,10,0
29-04-2022,PrimeSeven,1,984,564,969,329,640,91,62,68,55,13,1
29-04-2022,PrimeSeven,1,317,227,68,56,12,62,14,18,8,10,1
29-04-2022,Honeycomb,1,544,136,172,139,33,70,20,51,38,13,0
29-04-2022,Quicksilver,2,625,23,50,49,1,68,66,53,10,43,3
29-04-2023,Quicksilver,3,261,53,259,95,164,55,12,28,1,27,0
29-04-2023,Mustangs,2,154,44,75,64,11,69,39,36,0,36,0
29-04-2023,Honeycomb,3,733,432,535,382,153,96,93,48,29,19,2
29-04-2023,Quicksilver,3,897,608,623,21,602,75,66,64,2,62,5
29-04-2023,ImpactTraining,3,745,335,566,127,439,94,75,18,12,6,0
29-05-2021,Honeycomb,1,736,247,266,79,187,97,72,83,54,29,11
29-05-2021,Honeycomb,1,989,82,461,458,3,80,77,68,20,48,1
29-05-2021,Honeycomb,3,690,133,388,165,223,50,39,35,29,6,1
29-05-2021,BitterLaser,3,554,109,51,19,32,67,46,43,7,36,4
29-05-2021,ImpactTraining,1,542,405,476,18,458,74,44,16,5,11,0
29-05-2021,Mustangs,2,736,138,543,229,314,66,11,53,12,41,2
29-05-2021,BitterLaser,2,585,388,224,148,76,97,8,41,20,21,5
29-05-2021,GrayPanthers,1,829,538,724,349,375,69,52,44,43,1,2
29-05-2021,Aurora,1,568,218,241,102,139,85,3,69,42,27,9
29-05-2021,GrayPanthers,3,861,711,606,28,578,69,11,22,13,9,1
29-05-2022,Honeycomb,3,162,26,136,10,126,88,31,70,14,56,3
29-05-2022,PrimeSeven,2,786,711,386,121,265,70,56,64,24,40,2
29-05-2022,Aurora,3,645,99,16,11,5,80,17,66,50,16,2
29-05-2022,Honeycomb,3,242,111,67,42,25,52,46,4,3,1,0
29-05-2022,Mustangs,3,779,296,356,269,87,50,40,48,21,27,4
29-05-2022,Quicksilver,1,525,278,499,390,109,50,8,17,13,4,0
29-05-2022,Mustangs,2,143,95,6,1,5,58,17,38,28,10,2
29-05-2022,ImpactTraining,3,847,85,519,247,272,63,31,40,25,15,1
29-05-2022,Mustangs,3,424,173,133,115,18,97,90,2,1,1,0
29-05-2022,PrimeSeven,1,876,40,738,710,28,72,67,35,14,21,4
29-05-2023,ImpactTraining,3,277,145,271,52,219,93,11,31,29,2,3
29-05-2023,GrayPanthers,2,579,127,548,45,503,94,86,65,53,12,1
29-05-2023,Mustangs,3,646,511,234,71,163,54,14,12,3,9,0
29-05-2023,Mustangs,2,113,4,27,18,9,68,21,29,8,21,1
29-05-2023,CelestialInterface,3,651,482,563,260,303,73,7,26,23,3,1
29-05-2023,GrayPanthers,1,692,691,118,87,31,85,21,51,49,2,5
29-05-2023,Mustangs,1,636,171,588,462,126,51,49,16,10,6,1
29-05-2023,Aurora,1,838,675,818,263,555,71,35,45,30,15,4
29-06-2021,Honeycomb,1,310,169,13,12,1,58,35,28,19,9,0
29-06-2021,Honeycomb,3,677,153,505,456,49,69,42,54,16,38,5
29-06-2021,BitterLaser,1,181,158,22,11,11,86,76,77,34,43,8
29-06-2021,BitterLaser,1,324,317,241,126,115,79,77,72,54,18,6
29-06-2021,GrayPanthers,3,903,199,40,24,16,62,1,46,0,46,1
29-06-2021,ImpactTraining,2,150,46,144,139,5,54,9,34,15,19,2
29-06-2021,ImpactTraining,2,674,456,470,329,141,71,15,8,7,1,0
29-06-2021,Aurora,1,353,265,83,39,44,99,1,7,1,6,0
29-06-2021,GrayPanthers,1,813,247,662,155,507,89,50,71,43,28,9
29-06-2021,GrayPanthers,3,631,447,183,138,45,60,24,8,5,3,0
29-06-2021,PrimeSeven,3,158,48,9,6,3,88,44,62,57,5,1
29-06-2022,Quicksilver,1,186,166,141,0,141,52,41,29,27,2,1
29-06-2022,Aurora,1,225,193,222,189,33,60,32,54,35,19,2
29-06-2022,PrimeSeven,1,262,169,78,55,23,59,10,20,4,16,0
29-06-2022,GrayPanthers,1,924,420,781,458,323,96,7,54,32,22,2
29-06-2022,Honeycomb,1,111,69,19,15,4,55,48,15,10,5,1
29-06-2022,GrayPanthers,2,676,172,647,616,31,79,22,73,14,59,0
29-06-2022,Honeycomb,1,306,124,143,41,102,83,55,19,16,3,0
29-06-2023,Aurora,3,870,641,260,0,260,96,4,84,22,62,1
29-06-2023,Aurora,3,949,570,860,712,148,92,70,83,54,29,6
29-06-2023,CelestialInterface,3,340,239,291,48,243,56,0,30,12,18,2
29-06-2023,Discovery,2,707,252,554,12,542,57,45,35,14,21,4
29-06-2023,CelestialInterface,2,508,302,22,0,22,62,35,30,15,15,2
29-06-2023,Honeycomb,3,478,205,266,221,45,53,48,29,13,16,3
29-07-2021,ImpactTraining,3,228,95,146,123,23,53,42,33,7,26,0
29-07-2021,Quicksilver,3,404,340,55,30,25,95,10,28,27,1,0
29-07-2021,GrayPanthers,2,960,763,741,197,544,94,84,17,15,2,0
29-07-2021,Aurora,3,675,91,671,229,442,98,37,35,24,11,1
29-07-2021,GrayPanthers,3,334,158,320,7,313,84,79,59,9,50,2
29-07-2021,GrayPanthers,2,281,81,253,224,29,72,33,44,12,32,4
29-07-2022,ImpactTraining,3,678,636,247,43,204,92,30,24,18,6,2
29-07-2022,Discovery,1,525,207,273,237,36,85,17,82,38,44,7
29-07-2022,Aurora,2,301,108,40,31,9,77,44,8,2,6,0
29-07-2022,PrimeSeven,3,873,758,191,7,184,89,15,19,10,9,0
29-07-2022,PrimeSeven,3,778,434,472,165,307,97,54,95,82,13,3
29-07-2022,Quicksilver,3,670,638,138,38,100,57,31,54,20,34,3
29-07-2022,Honeycomb,3,784,739,730,19,711,57,31,8,0,8,0
29-07-2022,CelestialInterface,1,228,146,19,3,16,68,49,36,8,28,1
29-07-2022,GrayPanthers,2,541,243,12,7,5,67,26,38,20,18,3
29-07-2023,Discovery,3,186,63,174,118,56,57,14,2,0,2,0
29-07-2023,Honeycomb,1,147,118,99,43,56,91,12,79,26,53,3
29-07-2023,Quicksilver,3,259,253,133,102,31,52,41,5,1,4,0
29-07-2023,ImpactTraining,3,281,182,199,64,135,84,69,63,2,61,5
29-07-2023,PrimeSeven,3,299,97,136,51,85,74,3,48,42,6,5
29-07-2023,GrayPanthers,2,835,338,656,178,478,76,50,48,28,20,1
29-07-2023,Mustangs,3,241,107,34,16,18,70,8,48,26,22,2
29-07-2023,PrimeSeven,3,697,692,135,8,127,60,28,46,2,44,1
29-08-2021,Quicksilver,2,636,428,444,45,399,89,88,5,4,1,0
29-08-2021,CelestialInterface,3,940,727,805,524,281,66,22,10,4,6,0
29-08-2021,ImpactTraining,1,702,237,673,153,520,78,27,41,35,6,5
29-08-2021,Honeycomb,2,916,338,885,334,551,50,11,3,1,2,0
29-08-2021,Quicksilver,3,595,11,150,60,90,50,23,6,4,2,0
29-08-2021,Discovery,1,950,116,143,99,44,67,44,55,8,47,3
29-08-2021,Aurora,1,164,61,32,25,7,99,14,87,29,58,12
29-08-2022,Honeycomb,3,886,557,8,5,3,93,9,73,56,17,3
29-08-2022,Discovery,3,671,528,289,264,25,57,32,51,44,7,1
29-08-2022,BitterLaser,1,170,54,64,57,7,93,92,47,27,20,5
29-08-2022,CelestialInterface,3,919,639,754,78,676,60,18,13,10,3,0
29-08-2022,Quicksilver,1,959,237,101,21,80,66,6,14,8,6,1
29-08-2022,CelestialInterface,1,734,448,123,27,96,97,96,21,16,5,2
29-08-2022,BitterLaser,1,934,705,510,164,346,82,19,0,0,0,0
29-08-2022,Mustangs,3,232,209,185,169,16,78,45,20,13,7,1
29-08-2022,BitterLaser,2,876,1,572,199,373,62,5,45,16,29,5
29-08-2022,GrayPanthers,2,778,4,752,247,505,52,38,29,7,22,0
29-08-2022,Discovery,1,796,552,622,603,19,64,31,50,22,28,6
29-08-2022,Discovery,1,408,272,0,0,0,98,13,16,15,1,1
29-08-2023,PrimeSeven,3,339,173,6,1,5,60,8,8,4,4,0
29-08-2023,ImpactTraining,1,307,98,167,81,86,55,7,52,18,34,5
29-08-2023,BitterLaser,2,806,262,76,53,23,63,62,32,5,27,3
29-08-2023,BitterLaser,3,129,3,7,6,1,68,27,56,47,9,7
29-08-2023,GrayPanthers,1,832,287,479,354,125,54,9,24,13,11,0
29-08-2023,PrimeSeven,3,229,209,152,1,151,88,51,83,20,63,1
29-08-2023,PrimeSeven,2,481,247,78,67,11,79,47,76,33,43,0
29-08-2023,Quicksilver,3,569,132,450,283,167,81,48,72,66,6,8
29-08-2023,Honeycomb,2,360,80,247,66,181,93,0,12,6,6,0
29-08-2023,Mustangs,1,394,57,5,4,1,51,3,36,1,35,4
29-08-2023,PrimeSeven,1,866,187,665,640,25,90,2,58,26,32,2
29-08-2023,PrimeSeven,2,607,551,370,356,14,100,90,86,44,42,8
29-09-2021,Discovery,3,575,448,473,271,202,77,12,74,64,10,0
29-09-2021,CelestialInterface,1,269,9,88,50,38,77,45,19,16,3,1
29-09-2021,Quicksilver,1,904,498,692,656,36,81,67,5,2,3,0
29-09-2021,Aurora,3,166,39,56,52,4,96,30,81,51,30,2
29-09-2021,Discovery,2,445,403,386,16,370,97,30,29,2,27,3
29-09-2021,Discovery,1,359,84,106,12,94,61,45,24,13,11,1
29-09-2021,Discovery,1,113,75,66,27,39,88,3,43,21,22,5
29-09-2021,ImpactTraining,2,851,261,236,149,87,86,81,80,39,41,6
29-09-2021,PrimeSeven,1,113,31,18,11,7,98,77,57,0,57,4
29-09-2021,GrayPanthers,1,438,293,388,39,349,92,17,50,0,50,2
29-09-2021,Aurora,1,484,304,322,49,273,87,41,83,2,81,9
29-09-2021,BitterLaser,2,149,96,22,3,19,67,44,21,3,18,1
29-09-2021,Aurora,3,209,138,94,28,66,66,55,21,16,5,2
29-09-2022,Mustangs,3,231,128,52,12,40,62,56,16,13,3,1
29-09-2022,GrayPanthers,2,958,449,877,155,722,68,31,28,3,25,2
29-09-2022,Aurora,1,554,486,397,292,105,68,62,47,19,28,1
29-09-2022,Discovery,2,643,541,556,548,8,53,17,27,25,2,1
29-09-2022,BitterLaser,3,718,674,478,159,319,71,65,68,0,68,7
29-09-2022,CelestialInterface,1,395,202,217,178,39,96,44,91,53,38,4
29-09-2022,CelestialInterface,1,758,485,161,119,42,55,19,11,0,11,0
29-09-2022,Aurora,1,503,16,439,68,371,74,59,29,18,11,3
29-09-2023,Mustangs,3,939,205,311,8,303,97,6,0,0,0,0
29-09-2023,Aurora,2,630,420,250,249,1,73,43,35,18,17,1
29-09-2023,ImpactTraining,3,983,664,536,163,373,78,13,13,7,6,0
29-09-2023,Honeycomb,2,158,152,110,91,19,61,26,29,3,26,0
29-09-2023,ImpactTraining,2,725,609,372,313,59,64,2,33,13,20,1
29-09-2023,Quicksilver,3,103,83,10,9,1,96,45,92,16,76,2
29-09-2023,Discovery,2,422,304,262,8,254,75,68,2,0,2,0
29-09-2023,Quicksilver,3,659,508,163,100,63,100,83,51,20,31,4
29-10-2021,ImpactTraining,2,939,908,832,816,16,66,55,59,21,38,6
29-10-2021,CelestialInterface,3,914,158,842,223,619,89,47,55,49,6,0
29-10-2021,Mustangs,3,183,135,154,20,134,74,8,58,40,18,0
29-10-2021,CelestialInterface,3,978,795,510,300,210,87,71,40,20,20,3
29-10-2021,BitterLaser,1,169,121,56,21,35,79,32,65,49,16,1
29-10-2021,BitterLaser,2,300,298,281,279,2,55,50,41,23,18,0
29-10-2021,CelestialInterface,2,653,94,78,20,58,52,15,50,15,35,6
29-10-2021,CelestialInterface,1,350,334,185,37,148,88,64,87,68,19,4
29-10-2021,Mustangs,2,934,299,274,135,139,56,3,19,16,3,1
29-10-2021,Quicksilver,3,236,37,42,41,1,91,32,79,4,75,3
29-10-2021,Mustangs,2,862,384,581,260,321,57,41,49,45,4,1
29-10-2021,PrimeSeven,1,585,277,313,276,37,77,64,7,4,3,0
29-10-2021,Quicksilver,2,575,356,433,219,214,57,56,46,41,5,4
29-10-2021,BitterLaser,1,154,148,32,11,21,57,11,41,38,3,2
29-10-2022,Discovery,3,916,342,355,207,148,73,9,16,9,7,1
29-10-2022,Aurora,3,960,865,959,438,521,78,14,62,37,25,4
29-10-2022,CelestialInterface,1,459,22,272,86,186,73,23,9,2,7,0
29-10-2022,Discovery,2,238,11,149,137,12,62,29,45,19,26,3
29-10-2022,Aurora,2,700,254,176,26,150,76,15,10,9,1,0
29-10-2022,Mustangs,1,815,430,232,108,124,69,66,60,18,42,1
29-10-2022,Mustangs,1,747,486,537,89,448,87,77,9,0,9,0
29-10-2022,Aurora,3,920,397,715,378,337,81,52,37,17,20,3
29-10-2022,Honeycomb,1,353,9,327,161,166,77,74,74,12,62,3
29-10-2022,ImpactTraining,2,797,582,139,76,63,55,48,49,31,18,6
29-10-2023,Aurora,2,472,338,64,16,48,69,7,13,10,3,0
29-10-2023,Mustangs,2,712,195,66,54,12,76,42,10,2,8,0
29-10-2023,GrayPanthers,1,139,49,132,53,79,91,54,75,37,38,5
29-10-2023,Aurora,3,816,449,516,369,147,58,22,38,23,15,1
29-11-2021,GrayPanthers,2,277,225,264,251,13,60,14,26,19,7,2
29-11-2021,BitterLaser,3,552,458,385,4,381,84,63,50,21,29,0
29-11-2021,Honeycomb,3,107,37,13,12,1,52,46,19,8,11,1
29-11-2021,ImpactTraining,2,475,35,175,77,98,85,67,12,6,6,0
29-11-2021,Mustangs,2,315,60,163,44,119,61,33,34,17,17,1
29-11-2021,GrayPanthers,3,600,137,320,6,314,70,35,0,0,0,0
29-11-2021,Aurora,1,360,190,355,222,133,63,26,37,30,7,4
29-11-2021,BitterLaser,2,494,120,233,80,153,94,79,18,15,3,0
29-11-2021,PrimeSeven,2,502,87,140,32,108,79,11,29,23,6,0
29-11-2021,Honeycomb,3,195,132,116,65,51,100,97,92,18,74,11
29-11-2021,ImpactTraining,3,354,312,5,0,5,97,93,59,51,8,3
29-11-2021,Mustangs,2,693,137,554,280,274,67,40,15,4,11,0
29-11-2022,Discovery,2,354,113,87,34,53,81,63,51,16,35,5
29-11-2022,PrimeSeven,2,652,159,334,261,73,78,6,42,24,18,3
29-11-2022,Mustangs,2,391,335,194,1,193,83,34,69,12,57,2
29-11-2022,GrayPanthers,1,590,506,16,5,11,60,33,21,6,15,2
29-11-2022,BitterLaser,1,462,189,368,164,204,60,23,45,22,23,3
29-11-2022,Mustangs,1,508,320,384,187,197,80,1,40,29,11,5
29-11-2022,Mustangs,1,262,236,173,98,75,88,31,52,0,52,4
29-11-2022,BitterLaser,1,465,23,335,80,255,57,55,45,7,38,2
29-11-2022,Quicksilver,1,839,44,644,250,394,71,28,61,40,21,8
29-11-2022,PrimeSeven,2,237,57,126,71,55,59,40,29,28,1,2
29-11-2022,PrimeSeven,3,236,144,114,105,9,95,19,4,0,4,0
29-11-2022,Discovery,3,135,5,106,103,3,68,36,2,1,1,0
29-11-2022,GrayPanthers,2,781,440,752,413,339,82,19,45,34,11,4
29-11-2022,GrayPanthers,2,584,550,331,160,171,95,47,56,52,4,6
29-11-2022,Aurora,3,865,190,210,107,103,67,28,19,6,13,0
29-11-2022,Mustangs,1,205,176,142,40,102,76,17,4,1,3,0
29-11-2022,GrayPanthers,2,844,386,516,411,105,75,36,34,19,15,2
29-11-2023,Honeycomb,3,241,102,164,27,137,74,24,21,12,9,0
29-11-2023,PrimeSeven,3,346,109,197,37,160,74,25,50,26,24,2
29-11-2023,Quicksilver,2,515,450,344,123,221,54,23,29,5,24,1
29-11-2023,GrayPanthers,3,105,63,22,17,5,79,39,72,61,11,8
29-11-2023,CelestialInterface,3,753,321,442,44,398,86,52,37,7,30,4
29-11-2023,Discovery,2,512,0,412,326,86,54,21,3,0,3,0
29-11-2023,Mustangs,1,876,410,763,566,197,50,19,28,17,11,0
29-11-2023,CelestialInterface,1,643,516,255,164,91,95,32,88,78,10,2
29-11-2023,Honeycomb,1,481,284,186,86,100,55,0,11,3,8,0
29-11-2023,Honeycomb,3,159,148,103,37,66,94,39,93,45,48,7
29-12-2021,BitterLaser,3,966,426,574,106,468,80,9,64,27,37,1
29-12-2021,PrimeSeven,1,557,381,521,175,346,90,10,79,78,1,8
29-12-2021,BitterLaser,3,839,811,345,183,162,86,54,30,22,8,2
29-12-2021,GrayPanthers,2,566,365,7,4,3,50,29,38,17,21,0
29-12-2021,Mustangs,3,767,588,327,259,68,56,26,3,2,1,0
29-12-2021,Aurora,1,794,102,225,70,155,69,12,15,4,11,0
29-12-2021,ImpactTraining,1,261,5,214,172,42,85,39,77,33,44,6
29-12-2021,Quicksilver,1,119,70,23,13,10,71,22,55,48,7,3
29-12-2021,Mustangs,1,722,380,261,146,115,50,12,44,38,6,2
29-12-2021,CelestialInterface,3,936,522,23,15,8,74,51,42,10,32,4
29-12-2021,GrayPanthers,3,251,11,212,15,197,71,41,59,27,32,2
29-12-2021,PrimeSeven,1,196,13,173,49,124,88,21,28,23,5,2
29-12-2021,Discovery,2,621,557,153,127,26,54,0,30,22,8,0
29-12-2022,PrimeSeven,1,681,632,612,225,387,54,49,40,13,27,5
29-12-2022,Honeycomb,1,734,492,481,47,434,78,59,42,5,37,4
29-12-2022,CelestialInterface,2,862,102,745,580,165,99,50,54,9,45,4
29-12-2022,Mustangs,1,825,182,3,0,3,76,7,55,53,2,5
29-12-2022,BitterLaser,3,485,402,411,128,283,72,34,53,8,45,2
29-12-2022,Quicksilver,1,477,102,311,298,13,58,17,53,41,12,0
29-12-2022,GrayPanthers,1,128,33,68,52,16,75,62,41,30,11,1
29-12-2022,ImpactTraining,2,125,123,115,49,66,77,33,23,3,20,2
29-12-2022,Mustangs,1,445,138,202,81,121,70,60,35,20,15,4
29-12-2022,Honeycomb,1,545,162,142,127,15,87,35,81,80,1,4
29-12-2022,Aurora,3,247,107,36,34,2,60,0,38,28,10,1
29-12-2023,Aurora,3,664,157,76,16,60,56,24,27,14,13,2
29-12-2023,Discovery,2,225,38,33,3,30,79,17,10,1,9,0
29-12-2023,BitterLaser,3,175,31,69,32,37,63,23,9,7,2,0
29-12-2023,Honeycomb,1,777,94,201,195,6,86,1,11,7,4,0
29-12-2023,PrimeSeven,3,798,333,590,79,511,72,33,38,4,34,2
29-12-2023,Mustangs,2,251,12,29,1,28,60,24,32,27,5,1
30-01-2021,Quicksilver,2,900,821,668,295,373,54,37,28,25,3,3
30-01-2021,BitterLaser,3,301,157,195,60,135,72,65,21,9,12,2
30-01-2021,GrayPanthers,1,911,349,633,370,263,76,29,75,25,50,1
30-01-2021,GrayPanthers,1,657,16,608,427,181,69,60,14,5,9,0
30-01-2021,ImpactTraining,2,386,5,45,35,10,80,78,23,0,23,1
30-01-2021,BitterLaser,1,592,337,72,17,55,95,84,44,38,6,5
30-01-2021,BitterLaser,1,877,278,544,339,205,74,38,45,33,12,2
30-01-2021,BitterLaser,3,368,259,257,214,43,60,25,24,4,20,0
30-01-2022,PrimeSeven,1,272,165,80,5,75,91,24,16,9,7,1
30-01-2022,Discovery,2,629,7,141,130,11,77,60,7,5,2,0
30-01-2022,CelestialInterface,1,241,80,203,162,41,91,55,10,2,8,0
30-01-2022,Quicksilver,1,831,87,576,493,83,77,22,39,3,36,0
30-01-2022,GrayPanthers,3,791,254,157,55,102,70,22,12,0,12,0
30-01-2022,Mustangs,1,776,168,589,361,228,72,71,12,3,9,0
30-01-2022,ImpactTraining,2,902,381,319,227,92,76,13,37,17,20,1
30-01-2022,Quicksilver,3,267,45,109,26,83,59,57,42,14,28,0
30-01-2022,Quicksilver,1,414,222,94,35,59,82,80,13,12,1,0
30-01-2022,Aurora,1,549,193,55,0,55,57,56,15,1,14,1
30-01-2022,ImpactTraining,2,842,204,683,496,187,82,28,70,50,20,4
30-01-2023,Aurora,2,345,314,70,39,31,96,24,41,12,29,3
30-01-2023,Mustangs,2,964,918,509,274,235,54,21,47,11,36,2
30-01-2023,Quicksilver,1,460,82,276,202,74,53,35,23,15,8,0
30-01-2023,GrayPanthers,3,580,13,575,511,64,83,47,82,37,45,5
30-01-2023,PrimeSeven,1,728,582,17,8,9,79,57,14,8,6,1
30-01-2023,GrayPanthers,3,778,243,536,124,412,94,91,79,61,18,1
30-01-2023,Honeycomb,2,341,74,111,31,80,66,35,40,0,40,4
30-01-2023,Honeycomb,2,909,716,344,59,285,93,40,40,32,8,0
30-01-2023,BitterLaser,1,866,564,332,190,142,67,37,65,40,25,0
30-01-2023,Aurora,3,373,184,350,320,30,94,64,31,0,31,2
30-01-2023,BitterLaser,2,442,292,341,178,163,70,5,41,11,30,3
30-03-2021,ImpactTraining,1,173,117,24,20,4,67,1,30,28,2,2
30-03-2021,BitterLaser,3,760,515,448,350,98,90,19,47,27,20,4
30-03-2021,PrimeSeven,1,184,181,10,2,8,71,27,26,14,12,2
30-03-2021,Honeycomb,2,298,262,17,7,10,75,5,52,5,47,3
30-03-2021,PrimeSeven,1,133,69,50,22,28,61,4,5,4,1,0
30-03-2021,Honeycomb,2,230,38,136,102,34,84,47,50,6,44,1
30-03-2021,Quicksilver,2,138,17,81,68,13,82,25,5,0,5,0
30-03-2021,CelestialInterface,2,462,127,21,20,1,62,36,17,12,5,1
30-03-2021,Mustangs,1,281,165,154,125,29,93,22,87,17,70,12
30-03-2021,Quicksilver,2,842,605,522,513,9,65,22,39,19,20,0
30-03-2021,GrayPanthers,3,310,145,109,50,59,54,23,22,21,1,1
30-03-2021,GrayPanthers,3,483,135,290,255,35,56,18,17,15,2,0
30-03-2022,Aurora,1,446,112,323,105,218,77,29,14,4,10,0
30-03-2022,PrimeSeven,1,240,118,178,115,63,79,75,22,5,17,1
30-03-2022,GrayPanthers,2,370,339,299,172,127,89,18,27,6,21,1
30-03-2022,Quicksilver,2,848,156,401,158,243,91,25,16,15,1,0
30-03-2022,Honeycomb,1,188,120,108,14,94,60,53,19,8,11,1
30-03-2022,Quicksilver,2,304,177,300,195,105,95,18,18,10,8,1
30-03-2022,CelestialInterface,3,989,282,135,69,66,99,32,2,0,2,0
30-03-2022,CelestialInterface,2,698,471,434,271,163,85,5,73,17,56,5
30-03-2023,ImpactTraining,3,684,187,461,287,174,59,14,49,8,41,2
30-03-2023,Quicksilver,2,792,275,693,516,177,82,38,36,5,31,1
30-03-2023,GrayPanthers,2,722,660,126,68,58,83,48,53,37,16,3
30-03-2023,Quicksilver,1,652,183,26,20,6,55,25,6,1,5,0
30-03-2023,GrayPanthers,1,635,259,47,42,5,75,45,49,44,5,2
30-03-2023,ImpactTraining,2,692,21,391,213,178,94,84,88,47,41,11
30-03-2023,Aurora,1,241,45,147,69,78,75,20,58,56,2,1
30-04-2021,Quicksilver,3,131,92,60,4,56,93,82,22,19,3,1
30-04-2021,ImpactTraining,3,399,135,128,3,125,71,68,10,8,2,0
30-04-2021,Quicksilver,2,730,294,0,0,0,70,23,52,20,32,3
30-04-2021,CelestialInterface,2,914,496,473,355,118,61,47,28,5,23,0
30-04-2021,BitterLaser,1,618,362,99,31,68,97,50,48,36,12,5
30-04-2021,ImpactTraining,1,359,322,94,83,11,77,5,0,0,0,0
30-04-2021,CelestialInterface,2,100,87,31,22,9,62,0,42,29,13,2
30-04-2021,Mustangs,1,597,448,408,295,113,95,93,31,7,24,2
30-04-2021,Aurora,2,408,131,343,275,68,98,13,17,16,1,0
30-04-2021,CelestialInterface,3,994,485,546,67,479,80,52,37,33,4,3
30-04-2021,Aurora,2,239,171,21,0,21,87,52,66,57,9,0
30-04-2021,ImpactTraining,1,385,187,303,197,106,98,65,26,1,25,2
30-04-2021,Quicksilver,1,915,194,364,87,277,58,36,47,31,16,6
30-04-2022,Honeycomb,2,186,14,37,3,34,100,24,51,43,8,5
30-04-2022,Quicksilver,2,974,457,673,229,444,64,28,32,22,10,0
30-04-2022,PrimeSeven,2,265,17,264,6,258,91,57,87,20,67,2
30-04-2022,ImpactTraining,3,784,620,391,211,180,100,59,96,43,53,2
30-04-2022,CelestialInterface,3,809,582,60,56,4,94,23,60,45,15,1
30-04-2022,Honeycomb,3,596,575,65,20,45,93,68,11,0,11,0
30-04-2023,CelestialInterface,2,999,909,807,369,438,75,63,48,27,21,0
30-04-2023,GrayPanthers,2,170,17,15,9,6,70,57,21,3,18,1
30-04-2023,PrimeSeven,2,746,365,732,567,165,52,6,42,17,25,2
30-04-2023,PrimeSeven,3,896,398,217,77,140,93,14,90,47,43,7
30-04-2023,BitterLaser,2,330,165,329,143,186,61,50,38,34,4,2
30-04-2023,Aurora,2,885,406,119,0,119,75,9,6,0,6,0
30-04-2023,Mustangs,2,972,500,287,194,93,63,21,45,25,20,2
30-05-2021,CelestialInterface,2,389,8,345,284,61,92,16,88,71,17,5
30-05-2021,Quicksilver,2,408,22,124,112,12,82,74,57,4,53,4
30-05-2021,PrimeSeven,3,701,486,202,105,97,94,11,27,25,2,3
30-05-2021,Honeycomb,1,752,642,439,61,378,90,39,77,46,31,9
30-05-2021,Discovery,1,878,839,757,82,675,85,80,29,11,18,1
30-05-2021,Aurora,3,864,538,543,526,17,64,12,63,41,22,2
30-05-2021,Honeycomb,2,436,217,19,11,8,89,16,35,25,10,1
30-05-2021,ImpactTraining,1,855,486,805,566,239,84,69,7,5,2,0
30-05-2021,GrayPanthers,3,465,262,110,57,53,67,48,28,25,3,2
30-05-2021,Discovery,1,678,525,394,292,102,64,29,59,18,41,0
30-05-2021,PrimeSeven,3,477,201,421,406,15,90,19,45,14,31,5
30-05-2021,ImpactTraining,2,247,70,6,2,4,91,58,85,75,10,2
30-05-2021,Honeycomb,2,722,206,642,448,194,61,11,25,13,12,1
30-05-2021,ImpactTraining,1,989,984,900,468,432,87,26,10,6,4,0
30-05-2021,ImpactTraining,2,313,47,227,115,112,82,0,50,48,2,1
30-05-2022,ImpactTraining,1,301,204,58,50,8,67,63,35,30,5,1
30-05-2022,GrayPanthers,3,243,98,86,26,60,85,46,5,4,1,0
30-05-2022,CelestialInterface,3,745,360,685,181,504,86,2,72,23,49,5
30-05-2022,BitterLaser,2,451,233,179,74,105,56,26,27,2,25,3
30-05-2022,CelestialInterface,1,619,330,396,223,173,51,1,28,4,24,3
30-05-2023,CelestialInterface,3,817,412,760,575,185,87,33,62,58,4,2
30-05-2023,Quicksilver,3,966,512,653,131,522,50,37,44,31,13,3
30-05-2023,Discovery,2,834,4,20,11,9,92,19,59,29,30,4
30-05-2023,ImpactTraining,2,739,729,341,261,80,65,9,48,46,2,5
30-05-2023,ImpactTraining,1,645,369,233,213,20,85,33,43,19,24,3
30-05-2023,GrayPanthers,2,334,109,154,143,11,64,12,5,3,2,0
30-05-2023,PrimeSeven,2,489,125,335,323,12,88,7,45,27,18,2
30-05-2023,Honeycomb,1,414,167,298,194,104,84,67,44,0,44,4
30-06-2021,Mustangs,1,148,23,17,14,3,90,29,9,5,4,0
30-06-2021,GrayPanthers,2,178,36,138,130,8,90,75,63,15,48,7
30-06-2021,PrimeSeven,3,894,791,524,449,75,60,24,24,13,11,2
30-06-2021,CelestialInterface,1,673,67,430,357,73,64,33,22,21,1,1
30-06-2021,ImpactTraining,1,186,158,169,134,35,73,2,57,3,54,6
30-06-2021,Honeycomb,2,302,25,187,171,16,90,88,1,0,1,0
30-06-2021,Discovery,2,749,216,470,422,48,56,27,54,44,10,4
30-06-2021,Discovery,1,300,177,111,97,14,94,46,84,68,16,9
30-06-2022,ImpactTraining,2,155,62,124,104,20,81,19,49,23,26,6
30-06-2022,GrayPanthers,1,515,218,105,64,41,68,43,21,19,2,1
30-06-2022,Honeycomb,1,509,348,353,234,119,54,38,53,29,24,1
30-06-2022,Honeycomb,3,652,530,80,74,6,74,22,19,16,3,0
30-06-2023,ImpactTraining,1,744,680,357,57,300,74,59,62,54,8,7
30-06-2023,Discovery,2,623,387,522,369,153,71,53,24,13,11,2
30-06-2023,Quicksilver,2,324,142,140,14,126,66,65,52,28,24,2
30-06-2023,Aurora,1,546,235,538,118,420,87,75,61,35,26,8
30-06-2023,ImpactTraining,1,354,76,74,15,59,90,18,47,30,17,3
30-06-2023,Honeycomb,1,881,879,472,320,152,79,11,38,22,16,3
30-06-2023,ImpactTraining,3,153,142,29,16,13,66,30,58,46,12,1
30-06-2023,Quicksilver,1,228,117,156,9,147,95,68,81,69,12,6
30-06-2023,CelestialInterface,1,932,179,420,197,223,92,17,30,7,23,2
30-06-2023,Honeycomb,1,500,473,355,17,338,85,8,44,8,36,2
30-07-2021,GrayPanthers,2,542,132,114,1,113,55,14,51,22,29,6
30-07-2021,GrayPanthers,3,561,320,450,44,406,60,41,48,22,26,6
30-07-2021,PrimeSeven,2,644,4,351,10,341,61,11,34,32,2,0
30-07-2021,PrimeSeven,1,920,774,614,211,403,60,0,50,27,23,6
30-07-2021,ImpactTraining,2,314,189,90,2,88,92,45,60,24,36,8
30-07-2021,Quicksilver,2,785,204,82,47,35,62,40,33,22,11,0
30-07-2021,Quicksilver,2,323,255,255,100,155,54,27,32,23,9,2
30-07-2021,GrayPanthers,1,506,167,245,133,112,97,91,3,0,3,0
30-07-2021,Honeycomb,3,428,359,86,60,26,53,37,22,21,1,1
30-07-2021,ImpactTraining,2,223,208,55,24,31,64,27,25,2,23,1
30-07-2022,Aurora,2,997,251,138,37,101,99,0,22,20,2,1
30-07-2022,ImpactTraining,2,291,131,219,78,141,80,50,31,3,28,2
30-07-2022,Aurora,3,332,290,30,20,10,80,33,61,50,11,8
30-07-2022,GrayPanthers,2,414,247,242,66,176,76,20,42,19,23,0
30-07-2023,Quicksilver,3,387,285,194,143,51,96,70,65,50,15,7
30-07-2023,Quicksilver,3,441,366,410,204,206,64,4,50,14,36,1
30-07-2023,Mustangs,2,310,5,228,23,205,61,20,54,7,47,6
30-07-2023,ImpactTraining,3,587,261,354,151,203,86,50,52,20,32,2
30-07-2023,Honeycomb,2,776,241,452,76,376,60,54,4,0,4,0
30-07-2023,ImpactTraining,1,166,131,152,39,113,82,20,39,18,21,2
30-07-2023,GrayPanthers,3,597,350,92,87,5,67,23,21,6,15,0
30-08-2021,Discovery,3,913,546,335,242,93,99,62,72,1,71,9
30-08-2021,Mustangs,1,858,661,78,0,78,88,7,29,16,13,0
30-08-2021,PrimeSeven,1,170,41,45,17,28,72,31,36,16,20,2
30-08-2021,ImpactTraining,1,107,78,42,22,20,91,75,53,34,19,1
30-08-2021,PrimeSeven,2,324,214,179,2,177,98,62,22,13,9,2
30-08-2022,Discovery,1,427,341,332,104,228,90,67,32,27,5,2
30-08-2022,Honeycomb,3,674,294,216,163,53,68,66,5,0,5,0
30-08-2022,Discovery,3,784,88,754,605,149,90,3,57,33,24,0
30-08-2022,BitterLaser,2,748,187,327,229,98,100,68,37,6,31,1
30-08-2022,BitterLaser,1,989,727,128,82,46,52,5,21,18,3,0
30-08-2022,ImpactTraining,3,356,195,166,95,71,92,60,44,4,40,0
30-08-2022,GrayPanthers,2,817,469,754,652,102,74,52,42,37,5,0
30-08-2023,ImpactTraining,2,908,856,510,87,423,80,52,60,36,24,0
30-08-2023,Quicksilver,1,625,345,246,66,180,64,35,38,4,34,1
30-08-2023,Honeycomb,2,390,333,202,180,22,93,76,13,12,1,0
30-08-2023,Aurora,3,695,323,5,2,3,82,41,72,11,61,3
30-08-2023,GrayPanthers,2,235,149,43,4,39,53,36,51,38,13,1
30-08-2023,Discovery,3,981,740,716,125,591,54,27,47,19,28,0
30-08-2023,Aurora,2,622,595,240,138,102,70,50,64,52,12,7
30-08-2023,CelestialInterface,1,444,401,127,30,97,66,49,3,1,2,0
30-09-2021,ImpactTraining,2,154,144,21,5,16,55,25,22,15,7,2
30-09-2021,BitterLaser,3,600,421,277,273,4,62,6,17,6,11,1
30-09-2021,Honeycomb,2,848,256,130,93,37,91,29,81,52,29,8
30-09-2021,GrayPanthers,1,514,275,481,258,223,100,84,65,0,65,8
30-09-2021,Aurora,1,788,261,684,515,169,91,87,79,38,41,0
30-09-2021,Aurora,2,484,274,182,167,15,100,85,22,5,17,1
30-09-2021,CelestialInterface,3,599,219,364,231,133,81,30,47,45,2,3
30-09-2021,Aurora,2,575,289,85,69,16,83,48,14,13,1,0
30-09-2021,Mustangs,3,333,293,36,22,14,54,41,1,0,1,0
30-09-2021,Honeycomb,2,841,819,403,95,308,100,64,35,12,23,0
30-09-2021,GrayPanthers,3,696,179,173,33,140,58,32,34,29,5,1
30-09-2022,Aurora,3,517,167,12,4,8,97,9,75,7,68,7
30-09-2022,PrimeSeven,2,773,574,690,132,558,71,39,41,40,1,3
30-09-2022,BitterLaser,2,146,141,118,0,118,75,57,62,41,21,8
30-09-2022,Honeycomb,1,911,886,211,60,151,84,13,74,29,45,9
30-09-2022,Honeycomb,1,979,613,60,36,24,66,61,52,0,52,6
30-09-2022,PrimeSeven,3,616,98,121,102,19,54,19,13,10,3,0
30-09-2022,Aurora,1,452,214,400,296,104,81,32,10,0,10,0
30-09-2022,GrayPanthers,1,965,111,870,575,295,97,2,39,24,15,4
30-09-2022,CelestialInterface,1,488,411,374,210,164,71,7,19,7,12,1
30-09-2022,Honeycomb,3,256,161,222,8,214,100,78,6,5,1,0
30-09-2022,Discovery,3,694,74,560,491,69,90,65,83,9,74,1
30-09-2022,Aurora,2,999,741,203,22,181,71,6,48,40,8,4
30-09-2023,Quicksilver,1,739,295,312,141,171,71,49,18,16,2,1
30-09-2023,Mustangs,2,862,514,77,72,5,68,20,60,43,17,2
30-09-2023,GrayPanthers,2,732,177,349,339,10,88,49,61,16,45,5
30-09-2023,Mustangs,2,742,51,673,218,455,71,13,27,4,23,0
30-09-2023,BitterLaser,2,863,363,118,45,73,91,76,3,1,2,0
30-09-2023,GrayPanthers,2,256,176,194,64,130,68,6,59,4,55,2
30-09-2023,BitterLaser,1,943,732,329,300,29,63,50,33,0,33,1
30-10-2021,Quicksilver,2,492,332,263,89,174,74,44,63,38,25,8
30-10-2021,ImpactTraining,1,993,341,946,240,706,97,56,7,3,4,0
30-10-2021,Aurora,2,259,228,67,43,24,100,20,33,22,11,2
30-10-2021,ImpactTraining,1,469,191,413,232,181,60,58,35,1,34,3
30-10-2021,Mustangs,1,766,394,643,43,600,93,67,41,0,41,3
30-10-2021,BitterLaser,2,510,104,436,21,415,77,25,54,46,8,4
30-10-2021,Aurora,2,189,92,40,30,10,73,47,58,35,23,7
30-10-2021,GrayPanthers,3,566,556,0,0,0,65,42,54,22,32,3
30-10-2021,BitterLaser,1,690,152,307,157,150,61,48,26,6,20,0
30-10-2021,Mustangs,2,405,142,31,23,8,94,10,1,0,1,0
30-10-2021,BitterLaser,2,874,395,324,268,56,54,4,13,11,2,0
30-10-2021,BitterLaser,3,292,93,129,43,86,81,74,74,6,68,7
30-10-2022,ImpactTraining,3,248,213,229,166,63,54,22,37,36,1,0
30-10-2022,Discovery,2,530,23,388,301,87,67,51,34,28,6,2
30-10-2022,PrimeSeven,3,452,212,25,4,21,87,42,37,7,30,3
30-10-2022,Honeycomb,2,928,902,304,240,64,52,33,8,3,5,0
30-10-2023,ImpactTraining,2,834,613,448,366,82,93,74,81,28,53,3
30-10-2023,Aurora,3,268,176,84,14,70,85,75,10,0,10,0
30-10-2023,BitterLaser,3,956,320,726,139,587,90,11,79,0,79,10
30-10-2023,ImpactTraining,3,839,287,530,178,352,96,23,56,13,43,4
30-10-2023,PrimeSeven,2,600,10,584,172,412,76,33,44,5,39,3
30-10-2023,Discovery,2,612,8,57,35,22,96,36,92,59,33,7
30-10-2023,PrimeSeven,3,294,228,174,2,172,91,57,67,4,63,6
30-10-2023,PrimeSeven,1,490,93,470,30,440,98,60,76,48,28,2
30-10-2023,Discovery,2,840,371,502,195,307,74,40,41,23,18,3
30-10-2023,Discovery,1,928,605,159,111,48,96,89,57,11,46,1
30-11-2021,PrimeSeven,1,668,595,637,260,377,98,97,22,16,6,2
30-11-2021,BitterLaser,3,987,82,419,24,395,79,26,51,15,36,6
30-11-2021,BitterLaser,2,708,441,462,358,104,50,38,15,6,9,1
30-11-2021,CelestialInterface,1,962,393,162,60,102,77,11,16,2,14,1
30-11-2021,Mustangs,1,218,146,208,172,36,64,12,17,7,10,1
30-11-2021,Quicksilver,3,271,208,162,118,44,79,36,23,18,5,0
30-11-2021,Quicksilver,2,417,119,224,68,156,68,5,13,6,7,0
30-11-2021,Honeycomb,3,191,68,126,98,28,65,0,64,39,25,7
30-11-2021,Honeycomb,1,858,259,114,81,33,80,31,40,10,30,1
30-11-2022,GrayPanthers,3,787,332,613,128,485,67,6,43,6,37,0
30-11-2022,Discovery,1,498,245,80,25,55,65,26,21,18,3,1
30-11-2022,GrayPanthers,1,875,131,112,63,49,84,31,32,26,6,2
30-11-2022,Mustangs,3,213,22,45,4,41,100,43,52,38,14,1
30-11-2022,Mustangs,2,869,723,43,3,40,81,44,46,42,4,3
30-11-2022,Quicksilver,3,874,275,32,10,22,69,67,18,7,11,0
30-11-2022,PrimeSeven,1,167,146,72,16,56,89,68,23,14,9,2
30-11-2023,BitterLaser,2,387,140,353,73,280,84,13,75,47,28,3
30-11-2023,CelestialInterface,1,917,109,478,192,286,69,65,17,5,12,1
30-11-2023,Quicksilver,1,537,110,19,7,12,80,26,30,5,25,1
30-11-2023,ImpactTraining,3,117,1,21,10,11,53,43,39,27,12,4
30-12-2021,GrayPanthers,2,371,121,351,197,154,77,43,24,7,17,1
30-12-2021,Mustangs,1,668,88,430,65,365,85,67,65,14,51,1
30-12-2021,Mustangs,3,306,8,250,89,161,83,2,7,0,7,0
30-12-2021,Mustangs,1,640,292,453,28,425,50,46,1,0,1,0
30-12-2021,Discovery,2,325,32,82,61,21,79,41,37,14,23,3
30-12-2021,PrimeSeven,1,854,131,323,261,62,71,39,9,5,4,0
30-12-2022,Mustangs,1,423,12,271,74,197,62,34,38,8,30,4
30-12-2022,Discovery,2,998,858,580,338,242,50,9,11,4,7,0
30-12-2022,Honeycomb,3,185,126,48,1,47,62,44,8,6,2,0
30-12-2022,Honeycomb,3,657,201,304,78,226,87,77,28,10,18,1
30-12-2022,Discovery,3,503,139,96,26,70,85,42,58,17,41,5
30-12-2022,Quicksilver,2,435,401,8,2,6,66,15,53,31,22,6
30-12-2022,BitterLaser,1,552,373,200,195,5,82,31,51,37,14,2
30-12-2022,BitterLaser,1,679,122,231,31,200,70,48,10,6,4,0
30-12-2022,BitterLaser,2,255,79,84,20,64,79,19,16,4,12,0
30-12-2023,CelestialInterface,2,337,171,315,142,173,73,53,14,0,14,0
30-12-2023,BitterLaser,3,883,670,118,110,8,51,39,8,6,2,0
30-12-2023,Aurora,1,947,23,276,110,166,72,61,39,25,14,3
30-12-2023,Aurora,1,721,40,257,231,26,100,58,77,70,7,7
30-12-2023,ImpactTraining,1,704,126,26,20,6,88,39,49,48,1,0
30-12-2023,BitterLaser,3,281,6,180,76,104,82,58,42,16,26,1
30-12-2023,ImpactTraining,3,193,60,162,141,21,68,27,41,2,39,1
30-12-2023,PrimeSeven,1,858,122,66,27,39,75,49,56,7,49,3
30-12-2023,Honeycomb,3,459,209,130,93,37,76,3,54,49,5,5
30-12-2023,CelestialInterface,3,511,397,181,70,111,50,6,1,0,1,0
31-01-2021,CelestialInterface,3,206,152,173,52,121,95,85,22,10,12,2
31-01-2021,CelestialInterface,1,738,306,9,4,5,93,92,11,6,5,0
31-01-2021,ImpactTraining,3,156,126,74,37,37,59,25,4,2,2,0
31-01-2021,BitterLaser,1,403,344,73,47,26,71,69,66,24,42,8
31-01-2021,Mustangs,1,882,593,725,122,603,100,8,32,0,32,0
31-01-2021,PrimeSeven,2,733,148,498,85,413,61,56,31,26,5,3
31-01-2021,PrimeSeven,1,662,8,222,159,63,98,50,65,12,53,6
31-01-2021,GrayPanthers,2,349,11,268,199,69,74,73,30,11,19,3
31-01-2021,Discovery,2,351,255,159,146,13,76,7,15,9,6,1
31-01-2022,CelestialInterface,3,672,338,16,8,8,57,27,23,10,13,1
31-01-2022,BitterLaser,2,315,189,186,75,111,50,26,20,16,4,2
31-01-2022,ImpactTraining,3,922,26,760,677,83,72,26,63,56,7,0
31-01-2022,Honeycomb,3,191,61,149,7,142,97,72,57,50,7,6
31-01-2022,PrimeSeven,3,872,120,165,38,127,55,28,6,4,2,0
31-01-2022,Mustangs,1,675,328,198,174,24,96,16,14,9,5,0
31-01-2022,CelestialInterface,2,351,53,315,286,29,64,0,16,10,6,1
31-01-2022,Quicksilver,3,414,24,148,136,12,52,16,10,9,1,0
31-01-2022,GrayPanthers,1,863,408,65,62,3,75,20,17,1,16,1
31-01-2022,Aurora,3,615,315,457,336,121,75,1,5,0,5,0
31-01-2022,BitterLaser,2,611,199,364,202,162,68,32,56,32,24,5
31-01-2022,Aurora,3,392,101,290,112,178,74,59,35,24,11,0
31-01-2023,BitterLaser,2,501,417,238,87,151,63,60,54,28,26,1
31-01-2023,GrayPanthers,2,761,80,122,27,95,68,3,67,14,53,7
31-01-2023,Mustangs,1,469,211,67,13,54,71,31,4,3,1,0
31-01-2023,GrayPanthers,3,701,40,504,268,236,92,81,85,3,82,3
31-01-2023,Discovery,1,203,15,17,3,14,57,54,27,26,1,2
31-01-2023,Discovery,2,898,653,566,115,451,67,29,61,25,36,6
31-01-2023,ImpactTraining,1,637,4,604,457,147,90,85,27,15,12,1
31-01-2023,ImpactTraining,3,533,427,235,140,95,70,61,12,3,9,0
31-01-2023,ImpactTraining,1,560,507,74,33,41,53,41,14,9,5,0
31-03-2021,Quicksilver,1,753,173,148,36,112,60,40,6,5,1,0
31-03-2021,Honeycomb,1,407,285,354,23,331,80,65,62,58,4,8
31-03-2021,ImpactTraining,1,890,442,650,628,22,59,12,26,6,20,1
31-03-2021,CelestialInterface,1,204,92,48,29,19,77,3,3,2,1,0
31-03-2021,Honeycomb,1,512,265,499,218,281,71,0,45,43,2,3
31-03-2021,Quicksilver,1,311,203,171,17,154,99,96,58,22,36,4
31-03-2021,ImpactTraining,1,255,119,235,195,40,56,17,14,5,9,0
31-03-2021,PrimeSeven,3,715,593,217,205,12,77,18,10,2,8,0
31-03-2021,Discovery,3,823,104,723,394,329,80,5,59,11,48,6
31-03-2021,Discovery,2,834,616,153,16,137,94,88,82,59,23,5
31-03-2021,GrayPanthers,3,542,481,341,16,325,56,11,12,2,10,0
31-03-2022,Honeycomb,1,422,257,0,0,0,93,5,27,26,1,2
31-03-2022,Honeycomb,2,809,184,231,223,8,73,62,33,3,30,0
31-03-2022,Aurora,1,925,667,437,111,326,86,77,56,15,41,2
31-03-2022,CelestialInterface,1,501,10,380,157,223,69,51,17,15,2,1
31-03-2022,BitterLaser,2,931,655,881,331,550,93,63,43,5,38,4
31-03-2022,Mustangs,3,372,279,41,36,5,52,27,7,3,4,0
31-03-2022,Mustangs,1,101,95,100,94,6,80,28,50,42,8,6
31-03-2022,BitterLaser,2,753,340,580,453,127,86,49,84,77,7,11
31-03-2022,Discovery,3,443,306,206,82,124,53,27,2,0,2,0
31-03-2022,Discovery,2,261,168,245,150,95,52,9,3,0,3,0
31-03-2023,Quicksilver,1,450,283,347,56,291,53,27,41,21,20,3
31-03-2023,BitterLaser,1,697,278,282,113,169,100,84,77,3,74,8
31-03-2023,CelestialInterface,2,987,273,142,81,61,64,28,8,1,7,0
31-03-2023,ImpactTraining,2,722,626,88,77,11,83,54,24,18,6,2
31-03-2023,Aurora,2,133,53,126,41,85,84,80,8,2,6,0
31-03-2023,GrayPanthers,1,322,36,218,87,131,96,28,54,41,13,0
31-03-2023,Honeycomb,3,698,322,237,51,186,54,36,31,24,7,3
31-03-2023,Discovery,1,1000,735,954,803,151,94,64,91,82,9,5
31-03-2023,CelestialInterface,2,146,83,32,14,18,53,13,40,31,9,4
31-03-2023,Quicksilver,1,214,176,30,28,2,94,32,58,24,34,5
31-03-2023,Discovery,1,167,46,88,26,62,100,74,69,67,2,8
31-05-2021,PrimeSeven,1,704,296,51,24,27,96,27,7,3,4,0
31-05-2021,Honeycomb,1,689,344,41,20,21,57,54,3,1,2,0
31-05-2021,Aurora,1,846,247,550,26,524,66,59,24,8,16,2
31-05-2021,CelestialInterface,1,821,630,349,241,108,60,4,33,23,10,0
31-05-2021,Mustangs,2,437,120,304,93,211,83,37,80,29,51,0
31-05-2021,GrayPanthers,3,912,883,667,387,280,97,85,25,1,24,2
31-05-2021,ImpactTraining,3,113,1,70,57,13,97,33,85,60,25,6
31-05-2021,Quicksilver,2,414,398,289,26,263,85,17,15,5,10,0
31-05-2021,PrimeSeven,3,995,411,61,49,12,96,33,7,1,6,0
31-05-2021,Mustangs,1,154,96,5,1,4,73,20,2,1,1,0
31-05-2021,PrimeSeven,1,156,116,28,20,8,93,16,0,0,0,0
31-05-2021,BitterLaser,1,226,199,97,19,78,72,49,69,33,36,0
31-05-2021,ImpactTraining,1,893,743,819,385,434,94,91,26,11,15,0
31-05-2021,BitterLaser,1,895,13,241,108,133,98,14,77,48,29,2
31-05-2021,ImpactTraining,2,837,85,9,8,1,91,40,89,43,46,6
31-05-2021,PrimeSeven,1,181,12,42,39,3,84,48,55,29,26,1
31-05-2021,ImpactTraining,3,604,58,357,25,332,57,27,9,5,4,0
31-05-2022,GrayPanthers,1,871,262,57,23,34,69,21,9,8,1,0
31-05-2022,Aurora,1,596,78,286,34,252,78,65,21,16,5,1
31-05-2022,GrayPanthers,3,780,708,10,1,9,95,87,75,4,71,3
31-05-2022,PrimeSeven,3,704,11,517,99,418,67,18,9,8,1,0
31-05-2022,PrimeSeven,1,281,185,149,146,3,80,38,60,24,36,4
31-05-2022,Mustangs,3,646,133,596,553,43,83,76,73,56,17,7
31-05-2022,Quicksilver,3,121,95,77,0,77,89,39,76,73,3,9
31-05-2022,Aurora,3,909,886,66,4,62,59,44,14,9,5,0
31-05-2022,Mustangs,3,416,32,160,77,83,57,30,17,0,17,0
31-05-2023,PrimeSeven,2,815,300,311,92,219,95,7,54,20,34,7
31-05-2023,Honeycomb,1,760,409,508,369,139,54,29,53,2,51,4
31-05-2023,BitterLaser,2,103,43,27,9,18,69,34,37,7,30,3
31-05-2023,PrimeSeven,2,957,43,702,220,482,70,57,52,15,37,6
31-05-2023,ImpactTraining,3,599,133,386,71,315,77,65,62,22,40,0
31-05-2023,Discovery,3,602,426,153,123,30,99,34,16,5,11,1
31-05-2023,ImpactTraining,3,413,325,214,69,145,97,25,86,26,60,7
31-05-2023,BitterLaser,2,172,143,156,24,132,74,14,45,15,30,0
31-05-2023,Aurora,2,504,493,401,311,90,60,36,29,14,15,0
31-05-2023,Aurora,1,584,90,245,132,113,91,81,78,42,36,2
31-05-2023,Aurora,1,202,90,48,18,30,98,43,2,0,2,0
31-05-2023,Mustangs,1,665,358,394,346,48,90,23,15,13,2,1
31-05-2023,Aurora,1,441,318,305,95,210,63,9,16,1,15,0
31-05-2023,GrayPanthers,3,481,310,75,6,69,69,14,38,24,14,2
31-07-2021,CelestialInterface,1,706,348,681,631,50,54,31,49,6,43,5
31-07-2021,GrayPanthers,3,114,82,65,23,42,57,48,0,0,0,0
31-07-2021,CelestialInterface,2,486,475,191,155,36,74,44,70,35,35,5
31-07-2021,Honeycomb,3,341,113,308,58,250,95,21,25,4,21,0
31-07-2021,Honeycomb,1,551,304,448,258,190,91,20,34,3,31,2
31-07-2021,Aurora,1,775,234,232,46,186,83,11,80,63,17,3
31-07-2021,Aurora,2,154,14,52,14,38,59,39,24,13,11,2
31-07-2021,PrimeSeven,1,689,204,397,73,324,52,20,48,41,7,5
31-07-2021,GrayPanthers,2,871,421,826,588,238,90,73,48,29,19,4
31-07-2021,Quicksilver,2,314,263,212,152,60,96,19,64,11,53,3
31-07-2021,GrayPanthers,3,249,221,27,26,1,71,15,7,4,3,0
31-07-2021,Mustangs,3,427,415,286,105,181,75,31,1,0,1,0
31-07-2022,Discovery,2,846,60,786,208,578,63,9,2,0,2,0
31-07-2022,ImpactTraining,2,782,103,195,22,173,88,14,79,52,27,2
31-07-2022,Honeycomb,2,704,67,431,375,56,54,16,0,0,0,0
31-07-2022,BitterLaser,1,693,176,311,74,237,58,24,31,9,22,2
31-07-2022,PrimeSeven,2,124,93,20,19,1,50,25,34,11,23,0
31-07-2022,BitterLaser,1,619,194,330,156,174,51,33,18,0,18,0
31-07-2022,GrayPanthers,3,295,34,187,157,30,61,23,27,18,9,0
31-07-2023,GrayPanthers,3,737,444,693,138,555,97,41,44,33,11,5
31-07-2023,Mustangs,3,976,784,658,399,259,83,45,47,14,33,6
31-07-2023,ImpactTraining,2,846,538,27,20,7,72,43,24,10,14,1
31-07-2023,Aurora,3,971,722,694,466,228,52,42,16,0,16,0
31-07-2023,Discovery,3,413,314,144,9,135,83,78,3,1,2,0
31-07-2023,BitterLaser,2,161,60,151,86,65,82,75,66,17,49,7
31-07-2023,BitterLaser,2,461,165,160,74,86,98,92,20,13,7,1
31-07-2023,Discovery,1,365,347,300,247,53,70,50,11,4,7,0
31-07-2023,PrimeSeven,2,941,599,187,41,146,73,69,39,3,36,3
31-08-2021,Quicksilver,2,606,76,414,48,366,85,64,44,42,2,4
31-08-2021,GrayPanthers,1,147,116,119,59,60,73,10,45,0,45,3
31-08-2021,Mustangs,1,611,348,490,191,299,59,22,43,23,20,0
31-08-2021,PrimeSeven,2,472,156,444,110,334,81,60,6,5,1,0
31-08-2021,Aurora,3,687,243,523,488,35,99,61,31,23,8,3
31-08-2021,CelestialInterface,3,277,21,123,19,104,60,28,17,13,4,1
31-08-2021,PrimeSeven,3,234,127,23,2,21,53,3,37,10,27,4
31-08-2022,BitterLaser,1,124,105,10,7,3,75,8,0,0,0,0
31-08-2022,CelestialInterface,1,919,866,680,160,520,89,37,82,41,41,9
31-08-2022,Honeycomb,3,810,728,340,128,212,62,38,43,30,13,5
31-08-2022,PrimeSeven,2,654,545,587,154,433,60,53,32,22,10,3
31-08-2022,GrayPanthers,1,624,302,413,121,292,93,26,87,58,29,6
31-08-2022,Mustangs,1,676,125,514,97,417,84,62,68,55,13,9
31-08-2022,PrimeSeven,3,631,121,264,242,22,72,17,27,2,25,0
31-08-2023,Honeycomb,2,214,180,31,25,6,93,39,29,10,19,3
31-08-2023,PrimeSeven,3,841,120,239,198,41,89,21,87,47,40,7
31-08-2023,BitterLaser,1,939,281,879,499,380,64,36,34,18,16,0
31-08-2023,GrayPanthers,3,978,266,875,79,796,61,9,5,2,3,0
31-08-2023,Quicksilver,3,792,314,90,25,65,55,1,48,32,16,6
31-08-2023,PrimeSeven,2,721,464,614,500,114,51,32,34,5,29,4
31-08-2023,ImpactTraining,2,480,92,373,69,304,88,10,41,13,28,2
31-08-2023,Aurora,2,271,151,56,52,4,84,50,13,12,1,0
31-08-2023,BitterLaser,1,116,67,1,0,1,96,85,51,32,19,2
31-08-2023,PrimeSeven,2,845,626,383,26,357,94,93,19,1,18,0
31-10-2021,Honeycomb,3,766,686,133,75,58,76,38,73,14,59,1
31-10-2021,BitterLaser,1,390,99,68,60,8,82,70,27,10,17,1
31-10-2021,PrimeSeven,2,823,291,513,111,402,53,4,4,3,1,0
31-10-2021,Quicksilver,1,915,730,541,419,122,71,3,55,31,24,0
31-10-2021,Aurora,3,637,28,445,72,373,97,17,12,6,6,0
31-10-2021,GrayPanthers,2,946,230,501,495,6,57,34,9,4,5,0
31-10-2021,Quicksilver,2,616,255,299,123,176,76,38,19,15,4,1
31-10-2021,CelestialInterface,3,278,190,183,103,80,57,1,47,27,20,0
31-10-2021,Mustangs,2,423,240,204,131,73,53,12,20,6,14,1
31-10-2021,Honeycomb,1,142,112,34,9,25,90,22,74,40,34,5
31-10-2021,CelestialInterface,3,161,110,103,27,76,70,55,8,5,3,0
31-10-2021,Quicksilver,3,482,355,92,69,23,79,0,36,2,34,0
31-10-2022,ImpactTraining,3,933,325,136,10,126,66,43,12,11,1,0
31-10-2022,GrayPanthers,2,825,815,498,148,350,97,52,23,0,23,1
31-10-2022,Discovery,1,183,37,148,15,133,87,68,37,22,15,4
31-10-2022,ImpactTraining,3,688,576,232,127,105,75,59,22,5,17,2
31-10-2022,BitterLaser,3,987,108,885,797,88,68,7,6,4,2,0
31-10-2022,Quicksilver,1,482,20,343,323,20,52,49,50,1,49,6
31-10-2022,Discovery,1,979,659,484,254,230,73,72,66,17,49,0
31-10-2022,ImpactTraining,2,481,421,45,25,20,82,0,26,8,18,1
31-10-2023,Mustangs,2,271,65,75,3,72,67,2,8,4,4,0
31-10-2023,PrimeSeven,1,605,343,496,419,77,65,56,51,38,13,6
31-10-2023,Honeycomb,2,220,145,166,16,150,67,8,26,4,22,1
31-10-2023,BitterLaser,1,660,340,98,51,47,66,28,27,16,11,3
31-12-2020,Honeycomb,3,710,129,631,326,305,65,21,49,39,10,3
31-12-2020,PrimeSeven,1,122,115,21,6,15,89,19,88,32,56,7
31-12-2020,PrimeSeven,3,403,301,330,42,288,63,16,2,0,2,0
31-12-2021,Aurora,3,506,465,323,90,233,57,43,54,25,29,4
31-12-2021,ImpactTraining,2,414,316,173,6,167,79,61,57,18,39,2
31-12-2021,Mustangs,2,160,98,48,5,43,57,20,25,7,18,0
31-12-2021,PrimeSeven,1,940,201,806,66,740,91,66,73,36,37,2
31-12-2021,Aurora,3,425,163,31,4,27,65,21,19,16,3,1
31-12-2021,ImpactTraining,2,758,713,609,322,287,56,4,48,10,38,5
31-12-2021,Discovery,3,500,141,10,8,2,82,51,4,3,1,0
31-12-2021,ImpactTraining,2,198,57,111,31,80,59,52,11,8,3,0
31-12-2021,Mustangs,3,339,215,97,79,18,96,81,77,4,73,10
31-12-2022,Discovery,1,236,211,57,21,36,82,44,17,16,1,1
31-12-2022,PrimeSeven,2,725,457,254,10,244,82,73,68,29,39,9
31-12-2022,ImpactTraining,2,242,189,162,63,99,51,31,49,11,38,2
31-12-2022,Aurora,1,459,429,40,32,8,85,2,38,29,9,4
31-12-2022,Quicksilver,3,951,550,347,209,138,97,95,78,20,58,8
31-12-2022,PrimeSeven,2,707,646,80,54,26,74,9,2,0,2,0
31-12-2022,GrayPanthers,1,733,359,729,229,500,89,35,17,9,8,1
31-12-2022,Discovery,3,126,68,51,47,4,86,31,79,21,58,2
